00000000000000000000000000000000000000000000000000000000000000000000000000000000000000000000000000000000000000000000000000000000000000000000
11111111111111111111111111111111111111111111111111111111111111111111111111111111111111111111111111111111111111111111111111111111111111111110
11111111111111111111111111111111111111111111111111111111111111111111111111111111111111111111111111111111111111111111111111111111111111111110
11111111111111111111111111111111111111111111111111111111111111111111111111111111111111111111111111111111111111111111111111111111111111111110
11111111111111111111111111111111111111111111111111111111111111111111111111111111111111111111111111111111111111111111111111111111111111111110
11111111111111111111111111111111111111111111111111111111111111111111111111111111111111111111111111111111111111111111111111111111111111111110
11111111111111111111111111111111111111111111111111111111111111111111111111111111111111111111111111111111111111111111111111111111111111111110
11111111111111111111111111111111111111111111111111111111111111111111111111111111111111111111111111111111111111111111111111111111111111111110
11111111111111111111111111111111111111111111111111111111111111111111111111111111111111111111111111111111111111111111111111111111111111111110
11111111111111111111111111111111111111111111111111111111111111111111111111111111111111111111111111111111111111111111111111111111111111111110
11111111111111111111111111111111111111111111111111111111111111111111111111111111111111111111111111111111111111111111111111111111111111111110
11111111111111111111111111111111111111111111111111111111111111111111111111111111111111111111111111111111111111111111111111111111111111111110
11111111111111111111111111111111111111111111111111111111111111111111111111111111111111111111111111111111111111111111111111111111111111111110
11111111111111111111111111111111111111111111111111111111111111111111111111111111111111111111111111111111111111111111111111111111111111111110
11111111111111111111111111111111111111111111111111111111111111111111111111111111111111111111111111111111111111111111111111111111111111111110
11111111111111111111111111111111111111111111111111111111111111111111111111111111111111111111111111111111111111111111111111111111111111111110
11111111111111111111111111111111111111111111111111111111111111111111111111111111111111111111111111111111111111111111111111111111111111111110
11111111111111111111111111111111111111111111111111111111111111111111111111111111111111111111111111111111111111111111111111111111111111111110
11111111111111111111111111111111111111111111111111111111111111111111111111111111111111111111111111111111111111111111111111111111111111111110
11111111111111111111111111111111111111111111111111111111111111111111111111111111111111111111111111111111111111111111111111111111111111111110
11111111111111111111111111111111111111111111111111111111111111111111111111111111111111111111111111111111111111111111111111111111111111111110
11111111111111111111111111111111111111111111111111111111111111111111111111111111111111111111111111111111111111111111111111111111111111111110
11111111111111111111111111111111111111111111111111111111111111111111111111111111111111111111111111111111111111111111111111111111111111111110
11111111111111111111111111111111111111111111111111111111111111111111111111111111111111111111101111111111111111111111111111111111111111111110
11111111111111111111111111111111111111111111111111111111111111111111111111111111111111111110000111111111111111111111111111111111111111111110
11111111111111111111111111111111111111111111111111111111111111111111111111111111111111111100000011111111111111111111111111111111111111111110
11111111111111111111111111111111111111111111111111111111111111111111111111111111111111110000000001111111111111111111111111111111111111111110
11111111111111111111111111111111111111111111111111111111111111111111111111111111111111000000000000111111111111111111111111111111111111111110
11111111111111111111111111111111111111111111111111111111111111111111111111111111111110000000000000011111111111111111111111111111111111111110
11111111111111111111111111111111111111111111111111111111111111111111111111111111111000000000000000001111111111111111111111111111111111111110
11111111111111111111111111111111111111111111111111111111111111111111111111111111110000000000001000000111111111111111111111111111111111111110
11111111111111111111111111111111111111111111111111111111111111111111111111111111100000000000000100000111111111111111111111111111111111111110
11111111111111111111111111111111111111111111111111111111111111111111111111111111110000000000000010000011111111111111111111111111111111111110
11111111111111111111111111111111111111111111111111111111111111111111111111111111110000000000000011100000011111111111111111111111111111111110
11111111111111111111111111111111111111111111111111111111111111111111111111111111111000000000001100010000001111111111111111111111111111111110
11111111111111111111111111111111111111111111111111111111111111111111111111111111111100000000011000000000000111111111111111111111111111111110
11111111111111111111111111111111111111111111111111111111111111111100000000000000111100000001110000000000000011111111111111111111111111111110
11111111111111111111111111111111111111111111111111111111111111100000000000000000111111100011000000000000000001111111111111111111111111111110
11111111111111111111111111111111111111111111111111111111111111110000000000000000000000000111000000000000000001111111111111111111111111111110
11111111111111111111111111111111111111111111111111111111111111111000000000000000000000001111100000111000000000111111111111111111111111111110
11111111111111111111111111111111111111111111111111111111111111111100000000000000111111111111110001111100000000011111111111111111111111111110
11111111111111111111111111111111111111111111111111111111111111111111000000000000111111111111111001111100000000011111111111111111111111111110
11111111111111111111111111111111111111111111001111111111111111111111000000000000111111111111111111111100100000001111111111111111111111111110
11111111111111111111111111111111111111111110001111111111111111111111100000000000111111111111111111111110000000000111111111111111111111111110
11111111111111111111111111110000000000000000001111111111111111111111110000000000111111111111111111111111100000000011111111111111111111111110
11111111111111111111111111110000000000000000001111111111111111111111110000000000111111111111111111111111111000000011111111111111111111111110
11111111111111111111111111110000000000000000001111111111111111111111110000000000111111111111111111111111111110001001111111111111111111111110
11111111111111111111111111110000000000000000000111111111111111111111100000000000111111111111111111111111111111101101111111111111111111111110
11111111111111111111111111110000000000000000000011111111111111111111000000000000111111111111111111111111111111111100111111111111111111111110
11111111111111111111111111110000000000000000000011111111111111111111000000000000011111111111111111111111111111111110111111111111111111111110
11111111111111111111111111110000000000000000000001111111111111111110000000000000001111111111111111111111111111111110011111111111111111111110
11111111111111111111111111110000000000000000000000011111111111111100000000000000000111111111111111111111111111111110011111111111111111111110
11111111111111111111111111110000000000000000000000001111111111110000000000000000000000001111111111111111111111111111111111111111111111111110
11111111111111111111111111110000000000000000000000000111111111100000001100000000000000001111111111111111111111111111111111111111111111111110
11111111111111111111111111110000000000000000000000000000000000000000001100000000000000001111111111111111111111111111111111111111111111111110
11111111111111111111111111110000000000000000000000000000000000000000000000000000000000001111111111111111111111111111111111111111111111111110
11111111111111111111111111111111111111110000000000000000000000000000100000000000000000001111111111111111111111111111111111111111111111111110
11111111111111111111111111111111111111111100000000000000000000000000100000000000011000000111111111111111111111111111111111111111111111111110
11111111111111111111111111111111111111111110000000000000000000000000000000000000011000000011111111111111111111111111111111111111111111111110
11111111111111111111111111111111111111111111000000000000000000000000000000000000000000000001111111111111111111111111111111111111111111111110
11111111111111111111111111111111111111111111000000000000000000000000000000000000000000000000000011111111111111111111111111111111111111111110
11111111111111111111111111111111111111111111000000000011000110001100000000000000000011000000000011111111111111111111111111111111111111111110
11111111111111111111111111111111111111111111000000000011000110001100000000000000000011000000000011111111111111111111111111111111111111111110
11111111111111111111111111111111111111111111000000000000000000000000000000000001100000000000000011111111111111111111111111111111111111111110
11111111111111111111111111111111111111111111111100000000000000000000000000000001100000000000000011111111111111111111111111111111111111111110
11111111111111111111111111111111111111111111111110000000000000000000000000000000000000000000000001111111111111111111111111111111111111111110
11111111111111111111111111111111111111111111111111000000000000000000000000110000000000000000000000111111111111111111111111111111111111111110
11111111111111111111111111111111111111111111111111100000000000000000000000110000000011000000000000011111111111111111111111111111111111111110
11111111111111111111111111111111111111111111111111110000000000000000000000000000000011000000000000000000111111111111111111111111111111111110
11111111111111111111111111111111111111111111111111110000000000000000000110000000000000000000000000000000111111111111111111111111111111111110
11111111111111111111111111111111111111111111111111110011100000000000000000000000000000000000000000000000111111111111111111111111111111111110
11111111111111111111111111111111111111111111111111110011100000000000000000000000000000000000000000000000111111111111111111111111111111111110
11111111111111111111111111111111111111111111111111110011100000000000000000000000000000000000000000000000111111111111111111111111111111111110
11111111111111111111111111111111111001111111111111110011000000000000000000011000000000000000000000000000111111111111111111111111111111111110
11111111111111111111111111111111110000111111111111110000000000000000110000011000000000000000000000000000111111111111111111111111111111111110
11111111111111111111111111111111100000001111111111110000001110000000010000000000000000000000000000000000111111111111111111111111111111111110
11111111111111111111111111111111000000000111111111100000001111000000000000000000000000000000000000000000111111111111111111111111111111111110
11111111111111111111111111111110000000000011111111000000001111100000000000000000000000000000000000000000111111111111111111111111111111111110
11111111111111111111111111111100000000000001111110000000000000000000000000000000000000000000000000000000111111111111111111111111111111111110
11111111111111111111111111100000000000000000111100000000000000000000000000000000000000000000000000000000111111111111111111111111111111111110
11111111111111111111111111000000000000000000000000000001111111110000000000000000010000000000000000011111111111111111111111111111111111111110
11111111111111111111111111000000000000000000000000000011111111111100000000000000000000000000000000111111111111111111111111111111111111111110
11111111111111111111111110000000000000000000000000000111111111111100000000000000000000000000000001111111111111111111111111111111111111111110
11111111111111111111111110000000000110000000000000001111111111111110000000000000000000000000000011111111111111111111111111111111111111111110
11111111111111111111111110000000000110000000000000011111111111111111000000000010000000000000000011111111111111111111111111111111111111111110
11111111111111111111111111000000000000000000000000011111111111111111000000000000000000000000010011111111111111111111111111111111111111111110
11111111111111111111111111000000000000000000000000111111111111111111000000000000000000000000000011111111111111111111111111111111111111111110
11111111111111111111111111100000000000000000000000011111111111111111000000000000000000000000000011111111111111111111111111111111111111111110
11111111111111111111111111110000000000000000000000001111111111111111111110000000000000000001111111111111111111111111111111111111111111111110
11111111111111111111111111110000000000000000000000001111111111111111111111000000000000000011111111111111111111111111111111111111111111111110
11111111111111111111111111111000000000000000000000010011111111111111111111100000000000000111111111111111111111111111111111111111111111111110
11111111111111111111111111111100000000000000000000100001111111111111111111110000000000001111111111111111111111111111111111111111111111111110
11111111111111111111111111111100000000000000000000000001111111111111111111110000000000001111111111111111111111111111111111111111111111111110
11111111111111111111111111111110000000000000000000000000111111111111111111110110000000001111111111111111111111111111111111111111111111111110
11111111111111111111111111111111000000000000111000000000111111111111111111110110000000001111111111111111111111111111111111111111111111111110
11111111111111111111111111111111000000000000110000000001101111111111111111110000000000001111111111111111111111111111111111111111111111111110
11111111111111111111111111111111100000000000100000000011000111111111111111111111111111111111111111111111111111111111111111111111111111111110
11111111111111111111111111111111110000000001000000000110000011111111111111111111111111111111111111111111111111111111111111111111111111111110
11111111111111111111111111111111111000000010000000001100000011111111111111111111111111111111111111111111111111111111111111111111111111111110
11111111111111111111111111111111111100000100000000111000000001111111111111111111111111111111111111111111111111111111111111111111111111111110
11111111111111111111111111111111111110001000000001110000000001111111111111111111111111111111111111111111111111111111111111111111111111111110
11111111111111111111111111111111111111010000010011000000000000111111111111111111111111111111111111111111111111111111111111111111111111111110
11111111111111111111111111111111111111100000011110000000000000011111111111111111111111111111111111111111111111111111111111111111111111111110
11111111111111111111111111111111111111110000001100000000000000011111111111111111111111111111111111111111111111111111111111111111111111111110
11111111111111111111111111111111111111111110000110000000000000011111111111111111111111111111111111111111111111111111111111111111111111111110
11111111111111111111111111111111111111111110000011000000000000111111111111111111111111111111111111111111111111111111111111111111111111111110
11111111111111111111111111111111111111111110000001000000000001111111111111111111111111111111111111111111111111111111111111111111111111111110
11111111111111111111111111111111111111111110000000000000000011111111111111111111111111111111111111111111111111111111111111111111111111111110
11111111111111111111111111111111111111111111000000000000001111111111111111111111111111111111111111111111111111111111111111111111111111111110
11111111111111111111111111111111111111111111100000000000011111111111111111111111111111111111111111111111111111111111111111111111111111111110
11111111111111111111111111111111111111111111111000000000111111111111111111111111111111111111111111111111111111111111111111111111111111111110
11111111111111111111111111111111111111111111111100000001111111111111111111111111111111111111111111111111111111111111111111111111111111111110
11111111111111111111111111111111111111111111111110000011111111111111111111111111111111111111111111111111111111111111111111111111111111111110
11111111111111111111111111111111111111111111111111000111111111111111111111111111111111111111111111111111111111111111111111111111111111111110
11111111111111111111111111111111111111111111111111111111111111111111111111111111111111111111111111111111111111111111111111111111111111111110
11111111111111111111111111111111111111111111111111111111111111111111111111111111111111111111111111111111111111111111111111111111111111111110
11111111111111111111111111111111111111111111111111111111111111111111111111111111111111111111111111111111111111111111111111111111111111111110
11111111111111111111111111111111111111111111111111111111111111111111111111111111111111111111111111111111111111111111111111111111111111111110
11111111111111111111111111111111111111111111111111111111111111111111111111111111111111111111111111111111111111111111111111111111111111111110
11111111111111111111111111111111111111111111111111111111111111111111111111111111111111111111111111111111111111111111111111111111111111111110
11111111111111111111111111111111111111111111111111111111111111111111111111111111111111111111111111111111111111111111111111111111111111111110
11111111111111111111111111111111111111111111111111111111111111111111111111111111111111111111111111111111111111111111111111111111111111111110
11111111111111111111111111111111111111111111111111111111111111111111111111111111111111111111111111111111111111111111111111111111111111111110
11111111111111111111111111111111111111111111111111111111111111111111111111111111111111111111111111111111111111111111111111111111111111111110
11111111111111111111111111111111111111111111111111111111111111111111111111111111111111111111111111111111111111111111111111111111111111111110
11111111111111111111111111111111111111111111111111111111111111111111111111111111111111111111111111111111111111111111111111111111111111111110
11111111111111111111111111111111111111111111111111111111111111111111111111111111111111111111111111111111111111111111111111111111111111111110
11111111111111111111111111111111111111111111111111111111111111111111111111111111111111111111111111111111111111111111111111111111111111111110
11111111111111111111111111111111111111111111111111111111111111111111111111111111111111111111111111111111111111111111111111111111111111111110
11111111111111111111111111111111111111111111111111111111111111111111111111111111111111111111111111111111111111111111111111111111111111111110
11111111111111111111111111111111111111111111111111111111111111111111111111111111111111111111111111111111111111111111111111111111111111111110
11111111111111111111111111111111111111111111111111111111111111111111111111111111111111111111111111111111111111111111111111111111111111111110
11111111111111111111111111111111111111111111111111111111111111111111111111111111111111111111111111111111111111111111111111111111111111111110
11111111111111111111111111111111111111111111111111111111111111111111111111111111111111111111111111111111111111111111111111111111111111111110
11111111111111111111111111111111111111111111111111111111111111111111111111111111111111111111111111111111111111111111111111111111111111111110
11111111111111111111111111111111111111111111111111111111111111111111111111111111111111111111111111111111111111111111111111111111111111111110
11111111111111111111111111111111111111111111111111111111111111111111111111111111111111111111111111111111111111111111111111111111111111111110
11111111111111111111111111111111111111111111111111111111111111111111111111111111111111111111111111111111111111111111111111111111111111111110
11111111111111111111111111111111111111111111111111111111111111111111111111111111111111111111111111111111111111111111111111111111111111111110
11111111111111111111111111111111111111111111111111111111111111111111111111111111111111111111111111111111111111111111111111111111111111111110
