0000000000000000000000000000000000000000000000000000000000000000000000000000000000000000000000000000
1111111111111111111111111111111111111111111111111111111111111111111111111111111111111111111111111110
1111111111111111111111111111111111111111111111111111111111111111111111111111111111111111111111111110
1111111111111111111111111111111111111111111111111111111111111111111111111111111111111111111111111110
1111111111111111111111111111111111111111111111111111111111111111111111111111111111111111111111111110
1111111111111111111111111111111111111111111111111111111111111111111111111111111111111111111111111110
1111111111111111111111111111111111111111111111111111111111111111111111111111111111111111111111111110
1111111111111111111111111111111111111111111111111111111111111111111111111111111111111111111111111110
1111111111111111111111111111111111111111111111111111111111111111111111111111111111111111111111111110
1111111111111111111111111111111111111111111111111111111111111111111111111111111111111111111111111110
1111111111111111111111111111111111111111111111111111111111111111111111111111111111111111111111111110
1111111111111111111111111111111111111111111111111111111111111111111111111111111111111111111111111110
1111111111111111111111111111111111111111111111111111111111111111111111111111111111111111111111111110
1111111111111111111111111111111111111111111111111111111111111111111111111111111111111111111111111110
1111111111111111111111111111111111111111111111111111111111111111111111111111111111111111111111111110
1111111111111111111111111111111111111111111111111100000010111111111111111111111111111111111111111110
1111111111111111111111111111111111111111000000100000000000001111111111111111111111111111111111111110
1111111111111111111111111111111111111111000000000000000000001111111111111111111111111111111111111110
1111111111111111111111111111111111111111000000000000000000001111111111111111111111111111111111111110
1111111111111111111111111111111111111111000000000000000000001111011111111111111111111111111111111110
1111111111111111111111111111111111100000000000000000000000000000001111111111111111111111111111111110
1111111111111111111111111111111111100000000000000000000000000000001111111111111111111111111111111110
1111111111111111111111111111111111000000000000000000000000000000001111111111111111111111111111111110
1111111111111111111111111111111111000000000000000000000000000000001111111111111111111111111111111110
1111111111111111111111111111111111010000000000000000000000000000001111111111111111111111111111111110
1111111111111111111111111111111111000000000000000000000000000000001111111111111111111111111111111110
1111111111111111111111111111111111000000000000000000000000000000001111111111111111111111111111111110
1111111111111111111111111111111111000000000000000000000000000000001111111111111111111111111111111110
1111111111111111111111111111111111000000000000000000000000000000011111111111111111111111111111111110
1111111111111111111111111111111111000000000000000000000000000000001111111111111111111111111111111110
1111111111111111111111111111111111000000000000000000000000000000001111111111111111111111111111111110
1111111111111111111111111111111111100000000000000000000000000000001111111111111111111111111111111110
1111111111111111111111111111111111000000000000000000000000000000001111111111111111111111111111111110
1111111111111111111111111111111111000000000000000000000000000000001111111111111111111111111111111110
1111111111111111111111111111111111000000000000000000000000000000001111111111111111111111111111111110
1111111111111111111111111111111111000000000000000000000000000000001111111111111111111111111111111110
1111111111111111111111111111111111000000000000000000000000000000001111111111111111111111111111111110
1111111111111111111111111111111111000000000000000000000000000000001111111111111111111111111111111110
1111111111111111111111111111111111000000000000000000000000000000001111111111111111111111111111111110
1111111111111111111111111111111111000000000000000000000000000000001111111111111111111111111111111110
1111111111111111111111111111111111000000000000000000000000000000001111111111111111111111111111111110
1111111111111111111111111111111111000000000000000000000000000000011111111111111111111111111111111110
1111111111111111111111111111111111100000000000000000000000000000001111111111111111111111111111111110
1111111111111111111111111111111111111111000000000000000000001111111111111111111111111111111111111110
1111111111111111111111111111111111111111000000000000000000001111111111111111111111111111111111111110
1111111111111111111111111111111111111111000000000000000000001111111111111111111111111111111111111110
1111111111111111111111111111111111111111111000000000000000011111111111111111111111111111111111111110
1111111111111111111111111111111111111111111110000000000000111111111111111111111111111111111111111110
1111111111111111111111111111111111111111111111000000000011111111111111111111111111111111111111111110
1111111111111111111111111111111111111111111111000000000011111111111111111111111111111111111111111110
1111111111111111111111111111111111111111111111000000000111111111111111111111111111111111111111111110
1111111111111111111111111111111111111111111111000000001111111111111111111111111111111111111111111110
1111111111111111111111111111111111111111111111000000001111111111111111111111111111111111111111111110
1111111111111111111111111111111111111111111111000000001111111111111111111111111111111111111111111110
1111111111111111111111111111111111111111111111111111111111111111111111111111111111111111111111111110
1111111111111111111111111111111111111111111111111111111111111111111111111111111111111111111111111110
1111111111111111111111111111111111111111111111111111111111111111111111111111111111111111111111111110
1111111111111111111111111111111111111111111111111111111111111111111111111111111111111111111111111110
1111111111111111111111111111111111111111111111111111111111111111111111111111111111111111111111111110
1111111111111111111111111111111111111111111111111111111111111111111111111111111111111111111111111110
1111111111111111111111111111111111111111111111111111111111111111111111111111111111111111111111111110
1111111111111111111111111111111111111111111111111111111111111111111111111111111111111111111111111110
1111111111111111111111111111111111111111111111111111111111111111111111111111111111111111111111111110
1111111111111111111111111111111111111111111111111111111111111111111111111111111111111111111111111110
1111111111111111111111111111111111111111111111111111111111111111111111111111111111111111111111111110
1111111111111111111111111111111111111111111111111111111111111111111111111111111111111111111111111110
1111111111111111111111111111111111111111111111111111111111111111111111111111111111111111111111111110
1111111111111111111111111111111111111111111111111111111111111111111111111111111111111111111111111110
1111111111111111111111111111111111111111111111111111111111111111111111111111111111111111111111111110
1111111111111111111111111111111111111111111111111111111111111111111111111111111111111111111111111110
1111111111111111111111111111111111111111111111111111111111111111111111111111111111111111111111111110
1111111111111111111111111111111111111111111111111111111111111111111111111111111111111111111111111110
1111111111111111111111111111111111111111111111111111111111111111111111111111111111111111111111111110
1111111111111111111111111111111111111111111111111111111111111111111111111111111111111111111111111110
1111111111111111111111111111111111111111111111111111111111111111111111111111111111111111111111111110
1111111111111111111111111111111111111111111111111111111111111111111111111111111111111111111111111110
1111111111111111111111111111111111111111111111111111111111111111111111111111111111111111111111111110
1111111111111111111111111111111111111111111111111111111111111111111111111111111111111111111111111110
1111111111111111111111111111111111111111111111111111111111111111111111111111111111111111111111111110
1111111111111111111111111111111111111111111111111111111111111111111111111111111111111111111111111110
1111111111111111111111111111111111111111111111111111111111111111111111111111111111111111111111111110
1111111111111111111111111111111111111111111111111111111111111111111111111111111111111111111111111110
1111111111111111111111111111111111111111111111111111111111111111111111111111111111111111111111111110
1111111111111111111111111111111111111111111111111111111111111111111111111111111111111111111111111110
1111111111111111111111111111111111111111111111111111111111111111111111111111111111111111111111111110
1111111111111111111111111111111111111111111111111111111111111111111111111111111111111111111111111110
1111111111111111111111111111111111111111111111111111111111111111111111111111111111111111111111111110
1111111111111111111111111111111111110000000011000000001100000000011111111111111111111111111111111110
1111111111111111111111111111111111100000000001000000000000000000011111111111111111111111111111111110
1111111111111111111111111111111111100000010000000000000000000000011111111111111111111111111111111110
1111111111111111111111111111111111001000000000000000000000000001011111111111111111111111111111111110
1111111111111111111111111111111111000000000000000000000000000000011111111111111111111111111111111110
1111111111111111111111111111111111000000000000000000000000000000011111111111111111111111111111111110
1111111111111111111111111111111111000000000000000000000000000001011111111111111111111111111111111110
1111111111111111111111111111111111000000000000000000000000000000011111111111111111111111111111111110
1111111111111111111111111111111111010001000000000000000000000000011111111111111111111111111111111110
1111111111111111111111111111111111000000000000000000000000000001011111111111111111111111111111111110
1111111111111111111111111111111111000000000000000000000000000000011111111111111111111111111111111110
1111111111111111111111111111111111000000000000000000000000000000011111111111111111111111111111111110
1111111111111111111111111111111111000000000000000000000000000000011111111111111111111111111111111110
1111111111111111111111111111111111000000000000000000000000000000011111111111111111111111111111111110
1111111111111111111111111111111111010000000000000000000000000000011111111111111111111111111111111110
1111111111111111111111111111111111000000000000000000000000000000011111111111111111111111111111111110
1111111111111111111111111111111111000000000000000000000000000000011111111111111111111111111111111110
1111111111111111111111111111111111000000100000000000000000000000011111111111111111111111111111111110
1111111111111111111111111111111111000000000000000000000000000000011111111111111111111111111111111110
1111111111111111111111111111111111001000000000000000000000000000011111111111111111111111111111111110
1111111111111111111111111111111111000000000000000000000000000001011111111111111111111111111111111110
1111111111111111111111111111111111000000000000000000000000000000011111111111111111111111111111111110
1111111111111111111111111111111111000000000010000000000000000000011111111111111111111111111111111110
1111111111111111111111111111111111000000000000000000000000000000011111111111111111111111111111111110
1111111111111111111111111111111111010000000000000000000000000010011111111111111111111111111111111110
1111111111111111111111111111111111000000100000000000000000000000011111111111111111111111111111111110
1111111111111111111111111111111111000000000010000000000000000000011111111111111111111111111111111110
1111111111111111111111111111111111001000000000000000000000010000011111111111111111111111111111111110
1111111111111111111111111111111111000000000000000000000010000000011111111111111111111111111111111110
1111111111111111111111111111111111000000000000000000000000000000011111111111111111111111111111111110
1111111111111111111111111111111111111111111111111111111111111111111111111111111111111111111111111110
1111111111111111111111111111111111111111111111111111111111111111111111111111111111111111111111111110
1111111111111111111111111111111111111111111111111111111111111111111111111111111111111111111111111110
1111111111111111111111111111111111111111111111111111111111111111111111111111111111111111111111111110
1111111111111111111111111111111111111111111111111111111111111111111111111111111111111111111111111110
1111111111111111111111111111111111111111111111111111111111111111111111111111111111111111111111111110
1111111111111111111111111111111111111111111111111111111111111111111111111111111111111111111111111110
1111111111111111111111111111111111111111111111111111111111111111111111111111111111111111111111111110
1111111111111111111111111111111111111111111111111111111111111111111111111111111111111111111111111110
1111111111111111111111111111111111111111111111111111111111111111111111111111111111111111111111111110
1111111111111111111111111111111111111111111111111111111111111111111111111111111111111111111111111110
1111111111111111111111111111111111111111111111111111111111111111111111111111111111111111111111111110
1111111111111111111111111111111111111111111111111111111111111111111111111111111111111111111111111110
1111111111111111111111111111111111111111111111111111111111111111111111111111111111111111111111111110
1111111111111111111111111111111111111111111111111111111111111111111111111111111111111111111111111110
