00000000000000000000000000000000000000000000000000000000000000000000000000000000000000000000000000000000000000000000000000000000000000000000000000000000000000000000000000000000000000000000000000000000
11111111111111111111111111111111111111111111111111111111111111111111111111111111111111111111111111111111111111111111111111111111111111111111111111111111111111111111111111111111111111111111111111111110
11111111111111111111111111111111111111111111111111111111111111111111111111111111111111111111111111111111111111111111111111111111111111111111111111111111111111111111111111111111111111111111111111111110
11111111111111111111111111111111111111111111111111111111111111111111111111111111111111111111111111111111111111111111111111111111111111111111111111111111111111111111111111111111111111111111111111111110
11111111111111111111111111111111111111111111111111111111111111111111111111111111111111111111111111111111111111111111111111111111111111111111111111111111111111111111111111111111111111111111111111111110
11111111111111111111111111111111111111111111111111111111111111111111111111111111111111111111111111111111111111111111111111111111111111111111111111111111111111111111111111111111111111111111111111111110
11111111111111111111111111111111111111111111111111111111111111111111111111111111111111111111111111111111111111111111111111111111111111111111111111111111111111111111111111111111111111111111111111111110
11111111111111111111111111111111111111111111111111111111111111111111111111111111111111111111111111111111111111111111111111111111111111111111111111111111111111111111111111111111111111111111111111111110
11111111111111111111111111111111111111111111111111111111111111111111111111111111111111111111111111111111111111111111111111111111111111111111111111111111111111111111111111111111111111111111111111111110
11111111111111111111111111111111111111111111111111111111111111111111111111111111111111111111111111111111111111111111111111111111111111111111111111111111111111111111111111111111111111111111111111111110
11111111111111111111111111111111111111111111111111111111111111111111111111111111111111111111111111111111111111111111111111111111111111111111111111111111111111111111110010000000110000000000000011111110
11111111111111111111111111111111111111111111111111111111111111111111111111111111111111111111111111111111111111111111111111111111111111111111111111111111111111111111110000000000110000000000000011111110
11111111111111111111111111111111111111111111111111111111111111111111111111111111111111111111111111111111111111000011110000000000111111111111111111111111111111111111110000000000110000000000000011111110
11111111111111111111111111111111111111111111111111111111111111111111111111111111111111111111111111111111111111000011110000000000111111111111111111111111111111111111110010000001110000000000000011111110
11111111111111111111111111111111111111111111111111111111111111111111111111111111111111111111111111111111111111000000000000000000111111111111111111111111111111111111110000000011110000000000000011111110
11111111111111111111111111111111111111111111111111111111111111111111111111111111111111111111111111111111111111000000000000000000111111111111111111111111111111111111110000000011110000000000000011111110
11111111111111111111111111111111111111111111111111111111111111111111111111111111111111111111111111111111111111000000000000000000111111111111111111111111111111111111110000000011111111111100000011111110
11111111111111111111111111111111111111111111111111111111111111111111111111111111111111111111111111111111111111000000000000000001111111111111111111111111111111111111110000000011111111111100000011111110
11111111111111111111111111111111111111111111111111111111111111111111111111111111111111111111111111111111111100000000000000000000111111111111111111111111111111111111110001110000000000000000001111111110
11111111111111111111111111111111111111111111111111111111111111111111111111111111111111111111111111111111111100000000000000000001111111111111111111111111111111111111110001110000000000000000001111111110
11111111111100100000001100000000000011111111111111111111111111111111111111111111111111111111111111111111111100000000000000000001111111111111111111111111111111111111110001110000000000000000001111111110
11111111111100000000001100000000000011111111111111111111111111111111111111111111111111111111111111111111111100000000001111000001111111111111111111111111111111111111110000000000000000000000001111111110
11111111111100000000001100000000000111111111111111111111111111111111111111111111111111111111111111111111111100000000001111000001111111111111111111111111111111111111110000000000000000111100001111111110
11111111111100100000011100000000000111111111111111111111111111111111111111111111111111111111111111111111111100000000001111000000111111111111111111111111111111111111110000000000000011111100001111111110
11111111111100000000011100000000000111111111111111111111111111111111111111111111111111111111111111111111111111000000001111000000111111111111111111111111111111111111111111111111110011111100001111111110
11111111111100000000011111111111000111111111111111111111111111111111111111111111111111111111111111111111111111000000000000000000111111111111111111111111111111111111111111111111110000111100001111111110
11111111111100000000011100000000001111111111111111111111111111111111111111111111111111111111111111111111111111111111010000000001111111111111111111111111111111111111110000001111000000011000001111111110
11111111111100000000011100000000001111111111111111111111111111111111111111111111111111111111111111111111111111111111010000000001111111111111111111111111111111111111110000001111000000011000001111111110
11111111111100000000011100000000001111111111111111111111111111111111111111111111111111111111111111111111111111111111110000000001111111111111111111111111111111111111110000000000000000000000001111111110
11111111111100000000001100000000000011111111111111111111111111111111111111111111111111111111111111111111111111111111110000000001111111111111111111111111111111111111110011110000000000000000001111111110
11111111111111110000111111110000111111111111111111111111111111111111111111111111111111111111111111111111111111111111111111111111111111111111111111111111111111111111110011110000000000000000000011111110
11111111111111110000111111110000111111111111111111111111111111111111111111111111111111111111111111111111111111111111111111111111111111111111111111111111111111111111110011110000000000000000000011111110
11111111111100000000111111000000001111111111111111111111111111111111111111111111111111111111111111111111111111111111111111111111111111111111111111111111111111111111110001110000110000000000000011111110
11111111111100000000111111000000001111111111111111111111111111111111111111111111111111111111111111111111111111111111111111111111111111111111111111111111111111111111110000000000110000000000000011111110
11111111111100000000000000001110000011111111111111111111111111111111111111111111111111111111111111111111111111111111111111111111111111111111111111111111111111111111110000000000110000000000000011111110
11111111111100000000000000001111000011111111111111111111111111111111111001111111111111111111111111111111111111111111111111111111111111111111111111111111111111111111110000000001110000000000000011111110
11111111111100000000000000001111000011111111111111111111111111111111111001111111111111111111111111111111111111111111111111111111111111111111111111111111111111111111110000000001110000000000000011111110
11111111111100000000000000001110000011111111111111111111111111111100000000011111111111111111111111111111111111111111111111111111111111111111111111111111111111111111110000000001110000000000000011111110
11111111111100000000111100000000000011111111111111111111111111111100000000111111111111111111111111111111111111111111111111111111111111111111111111111111111111111111111111111111111111111111111111111110
11111111111100000000111100000000000011111111111111111111111111111111100000000011111111111111111111111111111111111111111111111111111111111111111111111111111111111111111111111111111111111111111111111110
11111111111111111111111111111111111111111111111111111111111111111111100000001111111111111111111111111111111111111111111111111111111111111111111111111111111111111111111111111111111111111111111111111110
11111111111111111111111111111111111111111111111111111111111111111111100000001111111111111111111111111111111111111111111111111111111111111111111111111111111111111111111111111111111111111111111111111110
11111111111111111111111111111111111111111111111111111111111111111100000000001111111111111111111111111111111111111111111111111111111111111111111111111111111111111111111111111111111111111111111111111110
11111111111111111111111111111111111111111111111111111111111111111111000000001111111111111111111111111111111111111111111111111111111111111111111111111111111111111111111111111111111111111111111111111110
11111111111111111111111111111111111111111111111111111111111111111111000000001111111111111111111111111111111111111111111111111111111111111111111111111111111111111111111111111111111111111111111111111110
11111111111111111111111111111111111111111111111111111111111111111100000000001111111111111111111111111111111111111111111111111111111111111111111111111111111111111111111111111111111111111111111111111110
11111111111111111111111111111111111111111111111111111111111111111100000000001111111111111111111111111111111111111111111111111111111111111111111111111111111111111111111111111111111111111111111111111110
11111111111111111111111111111111111111111111111111111111111111111100000000001111111111111111111111111111111111111111111111111111111111111111111111111111111111111111111111111111111111111111111111111110
11111111111111111111111111111111111111111111111111111111111111111101100000011111111111111111111111111111111111111111111111111111111111111111111111111111111111111111111111111111111111111111111111111110
11111111111111111111111111111111111111111111111111111111111111111111100000011111111111111111111111111111111111111111111111111111111111111111111111111111111111111111111111111111111111111111111111111110
11111111111111111111111111111111111111111111111111111111111111111111000000001111111111111111111111111111111111111111111111111111111111111111111111111111111111111111111111111111111111111111111111111110
11111111111111111111111111111111111111111111111111111111111111111111000000001111111111111111111111111111111111111111111111111111111111111111111111111111111111111111111111111111111111111111111111111110
11111111111111111111111111111111111111111111111111111111111111111111110000111111111111111111111111111111111111111111111111111111111111111111111111111111111111111111111111111111111111111111111111111110
11111111111111111111111111111111111111111111111111111111111111111111110000111111111111111111111111111111111111111111111111111111111111111111111111111111111111111111111111111111111111111111111111111110
11111111111111111111111111111111111111111111111111111111111111111111111111111111111111111111111111111111111111111111111111111111111111111111111111111111111111111111111111111111111111111111111111111110
11111111111111111111111111111111111111111111111111111111111111111111111111111111111111111111111111111111111111111111111111111111111111111111111111111111111111111111111111111111111111111111111111111110
11111111111111111111111111111111111111111111111111111111111111111111111111111111111111111111111111111111111111111111111111111111111111111111111111111111111111111111111111111111111111111111111111111110
11111111111111111111111111111111111111111111111111111111111111111111111111111111111111111111111111111111111111111111111111111111111111111111111111111111111111111111111111111111111111111111111111111110
11111111111111111111111111111111111111111111111111111111111111111111111111111111111111111111111111111111111111111111111111111111111111111111111111111111111111111111111111111111111111111111111111111110
11111111111111111111111111111111111111111111111111111111111111111111111111111111111111111111111111111111111111111111111111111111111111111111111111111111111111111111111111111111111111111111111111111110
11111111111111111111111111111111111111111111111111111111111111111111111111111111111111111111111111111111111111111111111111111111111111111111111111111111111111111111111111111111111111111111111111111110
11111111111111111111111111111111111111111111111111111111111111111111111111111111111111111111111111111111111111111111111111111111111111111111111111111111111111111111111111111111111111111111111111111110
11111111111111111111111111111111111111111111111111111111111111111111111111111111111111111111111111111111111111111111111111111111111111111111111111111111111111111111111111111111111111111111111111111110
11111111111111111111111111111111111111111111111111111111111111111111111111111111111111111111111111111111111111111111111111111111111111111111111111111111111111111111111111111111111111111111111111111110
11111111111111111111111111111111111111111111111111111111111111111111111111111111111111111111111111111111111111111111111111111111111111111111111111111111111111111111111111111111111111111111111111111110
11111111111111111111111111111111111111111111111111111111111111111111111111111111111111111111111111111111111111111111111111111111111111111111111111111111111111111111111111111111111111111111111111111110
11111111111111111111111111111111111111111111111111111111111111111111111111111111111111111111111111111111111111111111111111111111111111111111111111111111111111111111111111111111111111111111111111111110
11111111111111111111111111111111111111111111111111111111111111111111111111111111111111111111111111111111111111111111111111111111111111111111111111111111111111111111111111111111111111111111111111111110
11111111111111111111111111111111111111111111111111111111111111111111111111111111111111111111111111111111111111111111111111111111111111111111111111111111111111111111111111111111111111111111111111111110
11111111111111111111111111111111111111111111111111111111111111111111111111111111111111111111111111111111111111111111111111111111111111111111111111111111111111111111111111111111111111111111111111111110
11111111111111111111111111111111111111111111111111111111111111111111111111111111111111111111111111111111111111111111111111111111111111111111111111111111111111111111111111111111111111111111111111111110
11111111111111111111111111111111111111111111111111111111111111111111111111111111111111111111111111111111111111111111111111111111111111111111111111111111111111111111111111111111111111111111111111111110
11111111111111111111111111111111111111111111111111111111111111111111111111111111111111111111111111111111111111111111111111111111111111111111111111111111111111111111111111111111111111111111111111111110
11111111111111111111111111111111111111111111111111111111111111111111111111111111111111111111111111111111111111111111111111111111111111111111111111111111111111111111111111111111111111111111111111111110
11111111111111111111111111111111111111111111111111111111111111111111111111111111111111111111111111111111111111111111111111111111111111111111111111111111111111111111111111111111111111111111111111111110
11111111111111111111111111111111111111111111111111111111111111111111111111111111111111111111111111111111111111111111111111111111111111111111111111111111111111111111111111111111111111111111111111111110
11111111111111111111111111111111111111111111111111111111111111111111111111111111111111111111111111111111111111111111111111111111111111111111111111111111111111111111111111111111111111111111111111111110
11111111111111111111111111111111111111111111111111111111111111111111111111111111111111111111111111111111111111111111111111111111111111111111111111111111111111111111111111111111111111111111111111111110
11111111111111111111111111111111111111111111111111111111111111111111111111111111111111111111111111111111111111111111111111111111111111111111111111111111111111111111111111111111111111111111111111111110
11111111111111111111111111111111111111111111111111111111111111111111111111111111111111111111111111111111111111111111111111111111111111111111111111111111111111111111111111111111111111111111111111111110
11111111111111111111111111111111111111111111111111111111111111111111111111111111111111111111111111111111111111111111111111111111111111111111111111111111111111111111111111111111111111111111111111111110
11111111111111111111111111111111111111111111111111111111111111111111111111111111111111111111111111111111111111111111111111111111111111111111111111111111111111111111111111111111111111111111111111111110
11111111111100100000011111111111000000000000111111111111111111111111111111111111111111111111111111111111111111111111111111111111111111111111111111111100000000000000000000000000000000000000011111111110
11111111111100000000001111111111000000000000111111111111111111111111111111111111111111111111111111111111111111111111111111111111111111111111111111111101000000000000000000000000000000000000011111111110
11111111111100000000000000110000000000000000111111111111111111111111111111111111111111111111111111111111111111111111111111111111111111111111111111111101001000000000000000000000000000000000011111111110
11111111111100000000000010110000000000000000111111111111111111111111111111111111111111111111111111111111111111111111111111111111111111111111111111111101111000000000000000000000000000000000011111111110
11111111111100000000000000000000000000000000111111111111111111111111111111111111111111111111111111111111111111111111111111111111111111111111111111111100000000000000111100000000000000000000011111111110
11111111111100000000000000000000001111111111111111111111111111111111111111111111111111111111111111111111111111111111111111111111111111111111111111111100000000000000111100000001111111111000011111111110
11111111111100000000000000000000000000000000111111111111111111111111111111111111111111111111111111111111111111111111111111111111111111111111111111111100111100000000111100001111111111111000011111111110
11111111111100100000010000000000000000000000111111111111111111111111111111111111111111111111111111111111111111111111111111111111111111111111111111111100111100000000111100001111000000011000001111111110
11111111111100000000000000000000000000000011111111111111111111111111111111111111111111111111111111111111111111111111111111111111111111111111111111111100000000111100000000000011100000011000001111111110
11111111111100000000000000000000000000000011111111111111111111111111111111111111111111111111111111111111111111111111111111111111111111111111111111111100000000111100000000000011110000011000001111111110
11111111111100000000000000110000000000000000000011111111111111111111111111111111111111111111000000111111111111111111111111111111111111111111111111110000000000111100000000000011110000011000001111111110
11111111111100000000000000110000000000000000000011111111111111111111111111111111111111111111000000111111111111111111111111111111111111111111111111110000000000111100000000000011100000011000111111111110
11111111111100000000000000110000000000000000000011111111111111111111111111111111111100001110000000011111111111111111111111111111111111111111111111110000000000000000001111000000000000011000111111111110
11111111111100000000000000110000000000000000000011111111111111111111111111111111111100001100000000011111111111111111111111111111111111111111111111110000000000000000001111000000000000011000111111111110
11111111111111110000001111110000000000000000000011111111111111111111111111111111111100000000000000001111111111111111111111111111111111111111111111110000000000000000001111000000000000011000111111111110
11111111111111110000001111110000000000000000000011111111111111111111111111111111111100000000000000001111111111111111111111111111111111111111111111110000000000000000001110000000000000011000111111111110
11111111111100000000000000000000000000000000000011111111111111111111111111111111111100000000000000000011111111111111111111111111111111111111111111110000000011110000000000000011110000011000111111111110
11111111111100000010100000000000000000000000000011111111111111111111111111111111111100000000000000000011111111111111111111111111111111111111111111110000000011110000000000000011110000011000001111111110
11111111111100000000000000000000000000000011001111111111111111111111111111111111111100000000000000000011111111111111111111111111111111111111111111111100000011110000000000000011110000011000001111111110
11111111111100001111110000000000000000000011001111111111111111111111111111111111111100000000000000000011111111111111111111111111111111111111111111111100000011110000000000000011110000011000001111111110
11111111111100001111110000000000000000000000001111111111111111111111111111111111111100000111000011111111111111111111111111111111111111111111111111111100111100000000000000001111000000011000001111111110
11111111111100101111110000000000000000000000001111111111111111111111111111111111111100001111000011111111111111111111111111111111111111111111111111111100111100000000000000001111000111111000011111111110
11111111111100001111110000110000000000000000001111111111111111111111111111111111111100001111000011111111111111111111111111111111111111111111111111111100000000000011110000000001111111111000011111111110
11111111111100000000000000110000000000000000001111111111111111111111111111111111111100000111000011111111111111111111111111111111111111111111111111111100000000000011110000000000000000000000011111111110
11111111111100000010100000110000000000000000001111111111111111111111111111111111111100000000000000011111111111111111111111111111111111111111111111111100000000000011110000000000000000000000011111111110
11111111111100000000000000110000000000000000001111111111111111111111111111111111111100000000000000011111111111111111111111111111111111111111111111111100000000000001110000000000000000000000011111111110
11111111111100000000000000111111000000000000001111111111111111111111111111111111111100000000000000001111111111111111111111111111111111111111111111111100000000000000000000000000000000000000011111111110
11111111111100000000000000111111000000000000001111111111111111111111111111111111111100000000000000001111111111111111111111111111111111111111111111111100000000000000000000000000000000000000011111111110
11111111111111111111111111111111111111111111111111111111111111111111111111111111111111111111111111111111111111111111111111111111111111111111111111111111111111111111111111111111111111111111111111111110
11111111111111111111111111111111111111111111111111111111111111111111111111111111111111111111111111111111111111111111111111111111111111111111111111111111111111111111111111111111111111111111111111111110
11111111111111111111111111111111111111111111111111111111111111111111111111111111111111111111111111111111111111111111111111111111111111111111111111111111111111111111111111111111111111111111111111111110
11111111111111111111111111111111111111111111111111111111111111111111111111111111111111111111111111111111111111111111111111111111111111111111111111111111111111111111111111111111111111111111111111111110
11111111111111111111111111111111111111111111111111111111111111111111111111111111111111111111111111111111111111111111111111111111111111111111111111111111111111111111111111111111111111111111111111111110
11111111111111111111111111111111111111111111111111111111111111111111111111111111111111111111111111111111111111111111111111111111111111111111111111111111111111111111111111111111111111111111111111111110
11111111111111111111111111111111111111111111111111111111111111111111111111111111111111111111111111111111111111111111111111111111111111111111111111111111111111111111111111111111111111111111111111111110
11111111111111111111111111111111111111111111111111111111111111111111111111111111111111111111111111111111111111111111111111111111111111111111111111111111111111111111111111111111111111111111111111111110
11111111111111111111111111111111111111111111111111111111111111111111111111111111111111111111111111111111111111111111111111111111111111111111111111111111111111111111111111111111111111111111111111111110
11111111111111111111111111111111111111111111111111111111111111111111111111111111111111111111111111111111111111111111111111111111111111111111111111111111111111111111111111111111111111111111111111111110
