0000000000000000000000000000000000000000000000000000000000000000000000000000000000000000000000000000
1111111111111111111111111111111111111111111111111111111111111111111111111111111111111111111111111110
1111111111111111111111111111111111111111111111111111111111111111111111111111111111111111111111111110
1111111111111111111111111111111111111111111111111111111111111111111111111111111111111111111111111110
1111111111111111111111111111111111111111111111111111111111111111111111111111111111111111111111111110
1111111111111111111111111111111111111111111111111111111111111111111111111111111111111111111111111110
1111111111111111111111111111111111111111111111111111111111111111111111111111111111111111111111111110
1111111111111111111111111111111111111111111111111111111111111111111111111111111111111111111111111110
1111111111111111111111111111111111111111111111111111111111111111111111111111111111111111111111111110
1111111111111111111111111111111111111111111111111111111111111111111111111111111111111111111111111110
1111111111111111111111111111111111111111111111111111111111111111111111111111111111111111111111111110
1111111111111111111111111111111111111111111111111111111111111111111111111111111111111111111111111110
1111111111111111111111111111111111111111111111111111111111111111111111111111111111111111111111111110
1111111111111111111111111111111111111111000000000000111111111100000000011111111111111111111111111110
1111111111111111111111111111111111111111000000000000011111111000000000000001111111111111111111111110
1111111111111111111111111111111111111111000000000000000111110000000000000001111111111111111111111110
1111111111111111111111111111111111111111000000000000000000000000000000000001111111111111111111111110
1111111111111111111111111111111111111111000000000000000000000000000000000001111111111111111111111110
1111111111111111111111111111111111111110000000000000000000000000000000000001111111111111111111111110
1111111111111111111111111111111111111100000000000000000000000000000000000111111111111111111111111110
1111111111111111111111000000000000111000000000000000000000000000000000000111111111111111111111111110
1111111111111111111111000000000000000000000000000000000000000000000000000111111111111111111111111110
1111111111111111111111000000000000000000000000000000000000000000000000000111111111111111111111111110
1111111111111111111111000000000000001111111000000000000000000000000000000111111111111111111111111110
1111111111111111111111111111111111111111111100000000000000000000000000001111111111111111111111111110
1111111111111111111111111111110000111111111110000000000000000000000000011111111111111111111111111110
1111111111111111111111111111111110111111111111111111111111111111111111111111111111111111111111111110
1111111111111111111111111111111111111111111111111111111111111111111111111111111111111111111111111110
1111111111111111111111111111111111111111111111111100000000000000001111111111111111111111111111111110
1111111111111111111111111111111111111111111111111100000000000000001111111111111111111111111111111110
1111111111111111111111111111111111111111110000000000000000000000000000000011111111111111111111111110
1111111111111111111111111111111111111111110000000000000000000000000000000011111111111111111111111110
1111111111111111111111111111111111111111110000000000000000000000000000000011111111111111111111111110
1111111111111111111111111111111111111111110000000000000000000000000000000011111111111111111111111110
1111111111111111111111111111111111111111110000000000000000000000000000000011111111111111111111111110
1111111111111111111111111111111111111111110000000000000000000000000000000011111111111111111111111110
1111111111111111111111111111111111111111111111111100000000000000001111111111111111111111111111111110
1111111111111111111111111111111111111111111111111100000000000000001111111111111111111111111111111110
1111111111111111111111111111111111111111111111111111111111111111111111111111111111111111111111111110
1111111111111111111111111111111111111111111111111111111111111111111111111111111111111111111111111110
1111111111111111111111111111111111111111111111111111111111111111111111111111111111111111111111111110
1111111111111111111111111111111111111111111111111111111111111111111111111111111111111111111111111110
1111111111111111111111111111111111111111111111111111111111111111111111111111111111111111111111111110
1111111111111111111111111111111111111111111111111111111111111111111111111111111111111111111111111110
1111111111111111111111111111111111111111111111111111111111111111111111111111111111111111111111111110
1111111111111111111111111111111111111111111111111111111111111111111111111111111111111111111111111110
1111111111111111111111111111111111111111111111111111111111111111111111111111111111111111111111111110
1111111111111111111111111111111111111111111111111111111111111111111111111111111111111111111111111110
1111111111111111111111111111111111111111111111111111111111111111111111111111111111111111111111111110
1111111111111111111111111111111111111111111111111111111111111111111111111111111111111111111111111110
1111111111111111111111111111111111111111111111111111111111111111111111111111111111111111111111111110
1111111111111111111111111111111111111111111111111111111111111111111111111111111111111111111111111110
1111111111111111111111111111111111111111111111111111111111111111111111111111111111111111111111111110
1111111111111111111111111111111111111111111111111111111111111111111111111111111111111111111111111110
1111111111111111111111111111111111111111111111111111111111111111111111111111111111111111111111111110
1111111111111111111111111111111111111111111111111111111111111111111111111111111111111111111111111110
1111111111111111111111111111111111111111111111111111111111111111111111111111111111111111111111111110
1111111111111111111111111111111111111111111111111111111111111111111111111111111111111111111111111110
1111111111111111111111111111111111111111111111111111111111111111111111111111111111111111111111111110
1111111111111111111111111111111111111111111111111111111111111111111111111111111111111111111111111110
1111111111111111111111111111111111111111111111111111111111111111111111111111111111111111111111111110
1111111111111111111111111111111111111111111111111111111111111111111111111111111111111111111111111110
1111111111111111111111111111111111111111111111111111111111111111111111111111111111111111111111111110
1111111111111111111111111111111111111111111111111111111111111111111111111111111111111111111111111110
1111111111111111111111111111111111111111111111111111111111111111111111111111111111111111111111111110
1111111111111111111111111111111111111111111111111111111111111111111111111111111111111111111111111110
1111111111111111111111111111111111111111111111111111111111111111111111111111111111111111111111111110
1111111111111111111111111111111111111111111111111111111111111111111111111111111111111111111111111110
1111111111111111111111111111111111111111111111111111111111111111111111111111111111111111111111111110
1111111111111111111111111111111111111111111111111111111111111111111111111111111111111111111111111110
1111111111111111111111111111111111111111111111111111111111111111111111111111111111111111111111111110
1111111111111111111111111111111111111111111111111111111111111111111111111111111111111111111111111110
1111111111111111111111111111111111111111111111111111111111111111111111111111111111111111111111111110
1111111111111111111111111111111111111111111111111111111111111111111111111111111111111111111111111110
1111111111111111111111111111111111111111111111111111111111111111111111111111111111111111111111111110
1111111111111111111111111111111111111111111111111111111111111111111111111111111111111111111111111110
1111111111111111111111111111111111111111111111111111111111111111111111111111111111111111111111111110
1111111111111111111111111111111111111111111111111111111111111111111111111111111111111111111111111110
1111111111111111111111111111111111111111111111111111111111111111111111111111111111111111111111111110
1111111111111111111111111111111111111111111111111111111111111111111111111111111111111111111111111110
1111111111111111111111111111111111111111111111111111111111111111111111111111111111111111111111111110
1111111111111111111111111111111111111111111111111111111111111111111111111111111111111111111111111110
1111111111111111111111111111111111111111111111111111111111111111111111111111111111111111111111111110
1111111111111111111111111111111111111111111111111111111111111111111111111111111111111111111111111110
1111111111111111111111111111111111111111111111111111111111111111111111111111111111111111111111111110
1111111111111111111111111111111111111111111111111111111111111111111111111111111111111111111111111110
1111111111111111111111111111111111111111111111111111111111111111111111111111111111111111111111111110
1111111111111111111111111111111111111111111111111111111111111111111111111111111111111111111111111110
1111111111111111111111111111111111111111111111111111111111111111111111111111111111111111111111111110
1111111111111111111111111111111111111111111111111111111111111111111111111111111111111111111111111110
1111111111111111111111111111111111111111111111111111111111111111111111111111111111111111111111111110
1111111111111111111111111111111111111111111111111111111111111111111111111111111111111111111111111110
1111111111111111111111111111111111111111111111111111111111111111111111111111111111111111111111111110
1111111111111111111111111111111111111111111111111111111111111111111111111111111111111111111111111110
1111111111111111111111111111111111111111111111111111111111111111111111111111111111111111111111111110
1111111111111111111111111111111111111111111111111111111111111111111111111111111111111111111111111110
1111111111111111111111111111111111111111111111111111111111111111111111111111111111111111111111111110
1111111111111111111111111111111111111111111111111111111111111111111111111111111111111111111111111110
1111111111111111111111111111111111111111111111111111111111111111111111111111111111111111111111111110
1111111111111111111111111111111111111111111111111111111111111111111111111111111111111111111111111110
1111111111111111111111111111111111111111111111111111111111111111111111111111111111111111111111111110
1111111111111111111111111111111111111111111111111111111111111111111111111111111111111111111111111110
1111111111111111111111111111111111111111111111111111111111111111111111111111111111111111111111111110
1111111111111111111111111111111111111111111110000000011111111111111111111111111111111111111111111110
1111111111111111111111111111111111111111111110000000011111111111111111111111111111111111111111111110
1111111111111111111111111111111111111111111110000000011111111111111111111111111111111111111111111110
1111111111111111111111111111111111111111111100000000001111111111111111111111111111111111111111111110
1111111111111111111111111111111111111111111100011000001111111111111111111111111111111111111111111110
1111111111111111111111111111111111111111111100011000001111111111111111111111111111111111111111111110
1111111111111111111111111111111111111111111100000000001111111111111111111111111111111111111111111110
1111111111111111111111111111111111111111110000000000000011111111111111111111111111111111111111111110
1111111111111111111111111111111111111111110000000110000011111111111111111111111111111111111111111110
1111111111111111111111111111111111111111110000000110000011111111111111111111111111111111111111111110
1111111111111111111111111111111111111111110000000000000011111111111111111111111111111111111111111110
1111111111111111111111111111111111111111110000000000000011111111111111111111111111111111111111111110
1111111111111111111111111111111111111111110000000000000011111111111111111111111111111111111111111110
1111111111111111111111111111111111111111110000000000000011111111111111111111111111111111111111111110
1111111111111111111111111111111111111111110000000000000011111111111111111111111111111111111111111110
1111111111111111111111111111111111111111111111111111111111111111111111111111111111111111111111111110
1111111111111111111111111111111111111111111111111111111111111111111111111111111111111111111111111110
