0000000000000000000000000000000000000000000000000000000000000000000000000000000000000000000000000000
1111111111111111111111111111111111111111111111111111111111111111111111111111111111111111111111111110
1111111111111111111111111111111111111111111111111111111111111111111111111111111111111111111111111110
1111111111111111111111111111111111111111111111111111111111111111111111111111111111111111111111111110
1111111111111111111111111111111111111111111111111111111111111111111111111111111111111111111111111110
1111111111111111111111111111111111111111111111111111111111111111111111111111111111111111111111111110
1111111111111111111111111111111111111111111111111111111111111111111111111111111111111111111111111110
1111111111111111111111111111111111111111111111111111111111111111111111111111111111111111111111111110
1111111111111111111111111111111111111111111111111111111111111111111111111111111111111111111111111110
1111111111111111111111111111111111111111111111111111111111111111111111111111111111111111111111111110
1111111111111111111111111111111111111111111111111111111111111111111111111111111111111111111111111110
1111111111111111111111111111111111111111111111111111111111111111111111111111111111111111111111111110
1111111111111111111111111111111111111111111111000000001111111111111111111111111111111111111111111110
1111111111111111111111111111111111111111111110000000000111111111111111111111111111111111111111111110
1111111111111111111111111111111111111111111100000000000011111111111111111111111111111111111111111110
1111111111111111111111111111111111111111111100000000000011111111111111111111111111111111111111111110
1111111111111111111111111111111111111111111100000000000011111111111111111111111111111111111111111110
1111111111111111111111111111111111111111111100000000000011111111111111111111111111111111111111111110
1111111111111111111111111111111111111111111100000000000011111111111111111111111111111111111111111110
1111111111111111111111111111111111111111111100000000000011111111111111111111111111111111111111111110
1111111111111111111110000000000000000000000000000000000000000000000000000000000111111111111111111110
1111111111111111111100000000000000000000000000000000000000000000000000000000000011111111111111111110
1111111111111111111100000000000000000000000000500000050000000000000000000000000011111111111111111110
1111111111111111111100000000000000000000000000500000050000000000000000000000000011111111111111111110
1111111111111111111100000000000000000011110000500000050000111100000000000000000011111111111111111110
1111111111111111111100000000000000000011110000500000050000111100000000000000000011111111111111111110
1111111111111111111100000000000000000011110000500000050000111100000000000000000011111111111111111110
1111111111111111111100000000000000000011110000500000050000111100000000000000000011111111111111111110
1111111111111111111100000000115555555555555555500000055555555555555555110000000011111111111111111110
1111111111111111111100000000110000000000000000000000000000000000000000110000000011111111111111111110
1111111111111111111100000000500000000000000000000000000000000000000000050000000011111111111111111110
1111111111111111111100000000500000000000000000000000000000000000000000050000000011111111111111111110
1111111111111111111100000000500000000000000000000000000000000000000000050000000011111111111111111110
1111111111111111111100000000500000000000000000000000000000000000000000050000000011111111111111111110
1111111111111111111100000000500000000000000000000000000000000000000000050000000011111111111111111110
1111111111111111111100000000500000000000000000000000000000000000000000050000000011111111111111111110
1111111111111111111100000000500000000000000000000000000000000000000000050000000011111111111111111110
1111111111111111111100000000500000000000000000000000000000000000000000050000000011111111111111111110
1111111111111111111100000000500000000000000000000000000000000000000000050000000011111111111111111110
1111111111111111111100000000500000000000000000000000000000000000000000050000000011111111111111111110
1111111111111111111100000000500000000000000000000000000000000000000000050000000011111111111111111110
1111111111111111111100000000500000000000000000000000000000000000000000050000000011111111111111111110
1111111111111111111100000000500000000000000000000000000000000000000000050000000011111111111111111110
1111111111111111111100000000500000000000000000000000000000000000000000050000000011111111111111111110
1111111111111100000000000000500000000000000000000000000000000000000000050000000000000011111111111110
1111111111111000000000000000500000000000000000000000000000000000000000050000000000000001111111111110
1111111111110000000000555555500000000000000000000000000000000000000000055555550000000000111111111110
1111111111110000000000000000000000000000000000000000000000000000000000000000000000000000111111111110
1111111111110000000000000000000000000000000000000000000000000000000000000000000000000000111111111110
1111111111110000000000000000000000000000000000000000000000000000000000000000000000000000111111111110
1111111111110000000000000000000000000000000000000000000000000000000000000000000000000000111111111110
1111111111110000000000000000000000000000000000000000000000000000000000000000000000000000111111111110
1111111111110000000000000000000000000000000000000000000000000000000000000000000000000000111111111110
1111111111110000000000555555500000000000000000000000000000000000000000055555550000000000111111111110
1111111111111000000000000000500000000000000000000000000000000000000000050000000000000001111111111110
1111111111111100000000000000500000000000000000000000000000000000000000050000000000000011111111111110
1111111111111111111100000000500000000000000000000000000000000000000000050000000011111111111111111110
1111111111111111111100000000500000000000000000000000000000000000000000050000000011111111111111111110
1111111111111111111100000000500000000000000000000000000000000000000000050000000011111111111111111110
1111111111111111111100000000500000000000000000000000000000000000000000050000000011111111111111111110
1111111111111111111100000000500000000000000000000000000000000000000000050000000011111111111111111110
1111111111111111111100000000500000000000000000000000000000000000000000050000000011111111111111111110
1111111111111111111100000000500000000000000000000000000000000000000000050000000011111111111111111110
1111111111111111111100000000500000000000000000000000000000000000000000050000000011111111111111111110
1111111111111111111100000000500000000000000000000000000000000000000000050000000011111111111111111110
1111111111111111111100000000500000000000000000000000000000000000000000050000000011111111111111111110
1111111111111111111100000000500000000000000000000000000000000000000000050000000011111111111111111110
1111111111111111111100000000500000000000000000000000000000000000000000050000000011111111111111111110
1111111111111111111100000000500000000000000000000000000000000000000000050000000011111111111111111110
1111111111111111111100000000500000000000000000000000000000000000000000050000000011111111111111111110
1111111111111111111100000000110000000000000000000000000000000000000000110000000011111111111111111110
1111111111111111111100000000115555555555555555500000055555555555555555110000000011111111111111111110
1111111111111111111100000000000000000011110000500000050000111100000000000000000011111111111111111110
1111111111111111111100000000000000000011110000500000050000111100000000000000000011111111111111111110
1111111111111111111100000000000000000011110000500000050000111100000000000000000011111111111111111110
1111111111111111111100000000000000000011110000500000050000111100000000000000000011111111111111111110
1111111111111111111100000000000000000000000000500000050000000000000000000000000011111111111111111110
1111111111111111111100000000000000000000000000500000050000000000000000000000000011111111111111111110
1111111111111111111100000000000000000000000000000000000000000000000000000000000011111111111111111110
1111111111111111111110000000000000000000000000000000000000000000000000000000000111111111111111111110
1111111111111111111111111111111111111111111100000000000011111111111111111111111111111111111111111110
1111111111111111111111111111111111111111111100000000000011111111111111111111111111111111111111111110
1111111111111111111111111111111111111111111100000000000011111111111111111111111111111111111111111110
1111111111111111111111111111111111111111111100000000000011111111111111111111111111111111111111111110
1111111111111111111111111111111111111111111100000000000011111111111111111111111111111111111111111110
1111111111111111111111111111111111111111111100000000000011111111111111111111111111111111111111111110
1111111111111111111111111111111111111111111110000000000111111111111111111111111111111111111111111110
1111111111111111111111111111111111111111111111000000001111111111111111111111111111111111111111111110
1111111111111111111111111111111111111111111111111111111111111111111111111111111111111111111111111110
1111111111111111111111111111111111111111111111111111111111111111111111111111111111111111111111111110
1111111111111111111111111111111111111111111111111111111111111111111111111111111111111111111111111110
1111111111111111111111111111111111111111111111111111111111111111111111111111111111111111111111111110
1111111111111111111111111111111111111111111111111111111111111111111111111111111111111111111111111110
1111111111111111111111111111111111111111111111111111111111111111111111111111111111111111111111111110
1111111111111111111111111111111111111111111111111111111111111111111111111111111111111111111111111110
1111111111111111111111111111111111111111111111111111111111111111111111111111111111111111111111111110
1111111111111111111111111111111111111111111111111111111111111111111111111111111111111111111111111110
1111111111111111111111111111111111111111111111111111111111111111111111111111111111111111111111111110
1111111111111111111111111111111111111111111111111111111111111111111111111111111111111111111111111110
1111111111111111111111111111111111111111111111111111111111111111111111111111111111111111111111111110
