0000000000000000000000000000000000000000000000000000000000000000000000000000000000000000000000000000
1111111111111111111111111111111111111111111111111111111111111111111111111111111111111111111111111110
1111111111111111111111111111111111111111111111111111111111111111111111111111111111111111111111111110
1111111111111111111111111111111111111111111111111111111111111111111111111111111111111111111111111110
1111111111111111111111111111111111111111111111000000001111111111111111111111111111111111111111111110
1111111111111111111111111111111111111111111111000000001111111111111111111111111111111111111111111110
1111111111111111111111111111111111111111111111000000001111111111111111111111111111111111111111111110
1111111111111111111111111111111111111111111111000000001111111111111111111111111111111111111111111110
1111111111111111111111111111111111111111111111000000001111111111111111111111111111111111111111111110
1111111111111111111111111111111111111111111111000000001111111111111111111111111111111111111111111110
1111111111111111111111111111111111111111111111000000001111111111111111111111111111111111111111111110
1111111111111111111111111111111111111111111111000000001111111111111111111111111111111111111111111110
1111111111111111111111111111111111111111111111110000111111111111111111111111111111111111111111111110
1111111111111111111111111111111111111111111111110000111111111111111111111111111111111111111111111110
1111111111111111111111111111111111111111111111110000111111111111111111111111111111111111111111111110
1111111111111111111111111111111111111111111111110000111111111111111111111111111111111111111111111110
1111111111111111111111111111111111111111111111110000111111111111111111111111111111111111111111111110
1111111111111111111111111111111111111111111111110000111111111111111111111111111111111111111111111110
1111111111111111111111111111111111111111111111110000111111111111111111111111111111111111111111111110
1111111111111111111111111111111111111111111111110000111111111111111111111111111111111111111111111110
1111111111111111111111111111111111111111111111110000111111111111111111111111111111111111111111111110
1111111111111111111111111111111111111111111111110000111111111111111111111111111111111111111111111110
1111111111111111111111111111111111111111111111110000111111111111111111111111111111111111111111111110
1111111111111111111111111111111111111111111111110000111111111111111111111111111111111111111111111110
1111111111111111111111111111111111111111111111110000111111111111111111111111111111111111111111111110
1111111111111111111111111111111111111111111111110000111111111111111111111111111111111111111111111110
1111111111111111111111111111110000000000000000000000000000000000000000111111111111111111111111111110
1111111111111111111111111111110000000000000000000000000000000000000000111111111111111111111111111110
1111111111111111111111111111110000000000111000000000000001110000000000111111111111111111111111111110
1111111111111111111111111111110000000000111000000000000001110000000000111111111111111111111111111110
1111111111111111111111111100000000000000000000000000000000000000000000000011111111111111111111111110
1111111111111111111111111100000000000000000000000000000000000000000000000011111111111111111111111110
1111111111111111111111111100000000000000000000000000000000000000000000000011111111111111111111111110
1111111111111111111111111100000000000000000000000000000000000000000000000011111111111111111111111110
1111111111111111111111111100000000000000000000000000000000000000000000000011111111111111111111111110
1111111111111111111111111100000000000000000000000000000000000000000000000011111111111111111111111110
1111111111111111111111111100000000000000000000000000000000000000000000000011111111111111111111111110
1111111111111111111111111100000000000000000000000000000000000000000000000011111111111111111111111110
1111111111111111111111111100000000000000000000005555000000000000000000000011111111111111111111111110
1111111111111111111111111100000000000000005550001111000555000000000000000011111111111111111111111110
1111111111111111111111111100110000000000000050001111000500000000000000110011111111111111111111111110
1111111111111111111111111100110000000000000055555555555500000000000000110011111111111111111111111110
1111111111111111111111111100110000000005000000000000000000005000000000110011111111111111111111111110
1111111111111111111111111100000000000005000000000000000000005000000000000011111111111111111111111110
1111111111111111111111111100000000000005550000000000000000555000000000000011111111111111111111111110
1111111111111111111111111100000000000000050000000000000000500000000000000011111111111111111111111110
1111000000001111111111111100000000000000050000000000000000500000000000000011111111111111000000001110
1111000000001111111111111100000000000000050000000000000000500000000000000011111111111111000000001110
1111000000000000000000000000000000000051150000000000000000511500000000000000000000000000000000001110
1111000000000000000000000000000000000051150000000000000000511500000000000000000000000000000000001110
1111000000000000000000000000000000000051150000000000000000511500000000000000000000000000000000001110
1111000000000000000000000000000000000051150000000000000000511500000000000000000000000000000000001110
1111000000001111111111111100000000000000050000000000000000500000000000000011111111111111000000001110
1111000000001111111111111100000000000000050000000000000000500000000000000011111111111111000000001110
1111111111111111111111111100000000000000050000000000000000500000000000000011111111111111111111111110
1111111111111111111111111100000000000005550000000000000000555000000000000011111111111111111111111110
1111111111111111111111111100000000000005000000000000000000005000000000000011111111111111111111111110
1111111111111111111111111100110000000005000000000000000000005000000000110011111111111111111111111110
1111111111111111111111111100110000000000000055555555555500000000000000110011111111111111111111111110
1111111111111111111111111100110000000000000050001111000500000000000000110011111111111111111111111110
1111111111111111111111111100000000000000005550001111000555000000000000000011111111111111111111111110
1111111111111111111111111100000000000000000000005555000000000000000000000011111111111111111111111110
1111111111111111111111111100000000000000000000000000000000000000000000000011111111111111111111111110
1111111111111111111111111100000000000000000000000000000000000000000000000011111111111111111111111110
1111111111111111111111111100000000000000000000000000000000000000000000000011111111111111111111111110
1111111111111111111111111100000000000000000000000000000000000000000000000011111111111111111111111110
1111111111111111111111111100000000000000000000000000000000000000000000000011111111111111111111111110
1111111111111111111111111100000000000000000000000000000000000000000000000011111111111111111111111110
1111111111111111111111111100000000000000000000000000000000000000000000000011111111111111111111111110
1111111111111111111111111100000000000000000000000000000000000000000000000011111111111111111111111110
1111111111111111111111111111110000000000111000000000000001110000000000111111111111111111111111111110
1111111111111111111111111111110000000000111000000000000001110000000000111111111111111111111111111110
1111111111111111111111111111110000000000000000000000000000000000000000111111111111111111111111111110
1111111111111111111111111111110000000000000000000000000000000000000000111111111111111111111111111110
1111111111111111111111111111111111111111111111110000111111111111111111111111111111111111111111111110
1111111111111111111111111111111111111111111111110000111111111111111111111111111111111111111111111110
1111111111111111111111111111111111111111111111110000111111111111111111111111111111111111111111111110
1111111111111111111111111111111111111111111111110000111111111111111111111111111111111111111111111110
1111111111111111111111111111111111111111111111110000111111111111111111111111111111111111111111111110
1111111111111111111111111111111111111111111111110000111111111111111111111111111111111111111111111110
1111111111111111111111111111111111111111111111110000111111111111111111111111111111111111111111111110
1111111111111111111111111111111111111111111111110000111111111111111111111111111111111111111111111110
1111111111111111111111111111111111111111111111110000111111111111111111111111111111111111111111111110
1111111111111111111111111111111111111111111111110000111111111111111111111111111111111111111111111110
1111111111111111111111111111111111111111111111110000111111111111111111111111111111111111111111111110
1111111111111111111111111111111111111111111111110000111111111111111111111111111111111111111111111110
1111111111111111111111111111111111111111111111110000111111111111111111111111111111111111111111111110
1111111111111111111111111111111111111111111111110000111111111111111111111111111111111111111111111110
1111111111111111111111111111111111111111111111000000001111111111111111111111111111111111111111111110
1111111111111111111111111111111111111111111111000000001111111111111111111111111111111111111111111110
1111111111111111111111111111111111111111111111000000001111111111111111111111111111111111111111111110
1111111111111111111111111111111111111111111111000000001111111111111111111111111111111111111111111110
1111111111111111111111111111111111111111111111000000001111111111111111111111111111111111111111111110
1111111111111111111111111111111111111111111111000000001111111111111111111111111111111111111111111110
1111111111111111111111111111111111111111111111000000001111111111111111111111111111111111111111111110
1111111111111111111111111111111111111111111111000000001111111111111111111111111111111111111111111110
1111111111111111111111111111111111111111111111111111111111111111111111111111111111111111111111111110
1111111111111111111111111111111111111111111111111111111111111111111111111111111111111111111111111110
1111111111111111111111111111111111111111111111111111111111111111111111111111111111111111111111111110
1111111111111111111111111111111111111111111111111111111111111111111111111111111111111111111111111110
