0000000000000000000000000000000000000000000000000000000000000000000000000000000000000000000000000000
1111111111111111111111111111111111111111111111111111111111111111111111111111111111111111111111111110
1111111111111111111111111111111111111111111111111111111111111111111111111111111111111111111111111110
1111111111111111111111111111111111111111111111111111111111111111111111111111111111111111111111111110
1111111111111111111111111111111111111111111111111111111111111111111111111111111111111111111111111110
1111111111111111111111111111111111111111111111111111111111111111111111111111111111111111111111111110
1111111111111111111111111111111111111111111111111111111111111111111111111111111111111111111111111110
1111111111111111111111111111111111111111111111111111111111111111111111111111111111111111111111111110
1111111111111111111111111111111111111111111111111111111111111111111111111111111111111111111111111110
1111111111111111111111111111111111111111111111111111111111111111111111111111111111111111111111111110
1111111111111111111111111111111111111111111111111111111111111111111111111111111111111111111111111110
1111111111111111111111111111111111111111111111111111111111111111111111111111111111111111111111111110
1111111111111111111111111111111111111111111111111111111111111111111111111111111111111111111111111110
1111111111111111111111111111111111111111111111111111111111111111111111111111111111111111111111111110
1111111111111111111111111111111111111111111111111111111111111111111111111111111111111111111111111110
1111111111111111111111111111111111111111111111111111111111111111111111111111111111111111111111111110
1111111111111111111111111111111111111111111111111111111111111111111111111111111111111111111111111110
1111111111111111111111111111111111111111111111111111111111111111111111111111111111111111111111111110
1111111111111111111111111111111111111111111111111111111111111111111111111111111111111111111111111110
1111111111111111111111111111111111111111111111111111111111111111111111111111111111111111111111111110
1111111111111111111111111111111111111111111111111111111111111111111111111111111111111111111111111110
1111111111111111111111111111111111111111111111111111111111111111111111111111111111111111111111111110
1111111111111111111111111111111111111111111111110000111111111111111111111111111111111111111111111110
1111111111111111111111111111111111111111111111100000111111111111111111111111111111111111111111111110
1111111111111111111111111111111111111111111111100000111111111111111111111111111111111111111111111110
1111111111111111111111111111111111111111110000000000011100111111111111111111111111111111111111111110
1111111111111111111111111111111111110011110000000000000000011100111111111111111111111111111111111110
1111111111111111111111111111111111110001100000000000000000000000111111111111111111111111111111111110
1111111111111111111111111111111111000000000000000000000000000000001111111111111111111111111111111110
1111111111111111111111111111111111000000000000000000000000000000001111111111111111111111111111111110
1111111111111111111111111111111100000000000000000000000000000000000011111111111111111111111111111110
1111111111111111111111111111111100000000000000000000000000000000000011111111111111111111111111111110
1111111111111111111111111111110000000000000000000000000000000000000000111111111111111111111111111110
1111111111111111111111111111110000000000000000000000000000000000000000111111111111111111111111111110
1111111111111111111111111111000000000000000000000055110110000000000000001111111111111111111111111110
1111111111111111111111111111000000000000000000000055111110000000000000001111111111111111111111111110
1111111111111111111111111100000000000000000000000005511110000000005550000011111111111111111111111110
1111111111111111111111111100000000000000000000000005000550000050055500000011111111111111111111111110
1111111111111111111111110000000000000000000000000000000550000000000000000011111111111111111111111110
1111111111111111111111110000000000000000000000000000000550000000000000001111111111111111111111111110
1111111111111111111111000000000000000000000000000000000000000000000000001110001111111111111111111110
1111111111111111111111000000000000555500000000000000000000000000000000000000001111111111111111111110
1111111111111111111111000000000000055500000000000000000000000000000000000000001111111111111111111110
1111111111111111111111000000000000055000000000000000000000000000000000000000001111111111111111111110
1111111111111111111111000000000000005000000000000000000000000000000000000000001111111111111111111110
1111111111111111111111000000000000000000000000000000000000000000000000000000001111111111111111111110
1111111111111111111110000000000000000000000000000001110000000000000000000000000111111111111111111110
1111111111111111110000000000000000000000000000000011110000000000000000000000000000111111111111111110
1111111111111111110000000000000000000000000000000001110000000000000000000000000000111111111111111110
1111111111111111110000000000000000000000000000100101110000000000000000000000000000111111111111111110
1111111111111111110000000000000000000000000111111101110000000000000000000000000000111111111111111110
1111111111111111110000000011000000000000000111111100111000000000000000000000000000111111111111111110
1111111111111111110000000111000000000000000111111000111000000000000000000000000000111111111111111110
1111111111111111111110000111000000000000000000011000000000000000000000000000000111111111111111111110
1111111111111111111111001111100000000000000000011000000000000000000000000000001111111111111111111110
1111111111111111111111001111100000000000000000000000000000000000000000000000001111111111111111111110
1111111111111111111111000011100000000000000000000000000000000000000000000000001111111111111111111110
1111111111111111111111000000000000000000000000000000000000000000000000000000001111111111111111111110
1111111111111111111111000000000000000000000000000000000000550000000000000000001111111111111111111110
1111111111111111111111000000000000000000000000000000000005550000000000000000001111111111111111111110
1111111111111111111111110000000000000011110000000000000005555000000000000000111111111111111111111110
1111111111111111111111110000000000001111111100000000000000005000000000000000111111111111111111111110
1111111111111111111111111100000000001100111100000000000000000000000000000011111111111111111111111110
1111111111111111111111111100000000000000011100000000000000000000000000000011111111111111111111111110
1111111111111111111111111111000000000000011100000000005555000000000000001111111111111111111111111110
1111111111111111111111111111000000000000011100000000000055500000000000001111111111111111111111111110
1111111111111111111111111111110000000000111100000000000000000000000110111111111111111111111111111110
1111111111111111111111111111110000000011111000000000000000000000001111111111111111111111111111111110
1111111111111111111111111111111100000111110000000000000000000011111111111111111111111111111111111110
1111111111111111111111111111111100000110000000000000000000000111111111111111111111111111111111111110
1111111111111111111111111111111111000000000000000000000000000111111111111111111111111111111111111110
1111111111111111111111111111111111000000000000000000000000000111111111111111111111111111111111111110
1111111111111111111111111111111111110000000000000000000000000000111111111111111111111111111111111110
1111111111111111111111111111111111110000000000000000011111100000111111111111111111111111111111111110
1111111111111111111111111111111111111100000000000000011111100011111111111111111111111111111111111110
1111111111111111111111111111111111111100000000000000011111100011111111111111111111111111111111111110
1111111111111111111111111111111111111111000000000000011111111111111111111111111111111111111111111110
1111111111111111111111111111111111111111000000110000111111111111111111111111111111111111111111111110
1111111111111111111111111111111111111111111111111111111111111111111111111111111111111111111111111110
1111111111111111111111111111111111111111111111111111111111111111111111111111111111111111111111111110
1111111111111111111111111111111111111111111111111111111111111111111111111111111111111111111111111110
1111111111111111111111111111111111111111111111111111111111111111111111111111111111111111111111111110
1111111111111111111111111111111111111111111111111111111111111111111111111111111111111111111111111110
1111111111111111111111111111111111111111111111111111111111111111111111111111111111111111111111111110
1111111111111111111111111111111111111111111111111111111111111111111111111111111111111111111111111110
1111111111111111111111111111111111111111111111111111111111111111111111111111111111111111111111111110
1111111111111111111111111111111111111111111111111111111111111111111111111111111111111111111111111110
1111111111111111111111111111111111111111111111111111111111111111111111111111111111111111111111111110
1111111111111111111111111111111111111111111111111111111111111111111111111111111111111111111111111110
1111111111111111111111111111111111111111111111111111111111111111111111111111111111111111111111111110
1111111111111111111111111111111111111111111111111111111111111111111111111111111111111111111111111110
1111111111111111111111111111111111111111111111111111111111111111111111111111111111111111111111111110
1111111111111111111111111111111111111111111111111111111111111111111111111111111111111111111111111110
1111111111111111111111111111111111111111111111111111111111111111111111111111111111111111111111111110
1111111111111111111111111111111111111111111111111111111111111111111111111111111111111111111111111110
1111111111111111111111111111111111111111111111111111111111111111111111111111111111111111111111111110
1111111111111111111111111111111111111111111111111111111111111111111111111111111111111111111111111110
1111111111111111111111111111111111111111111111111111111111111111111111111111111111111111111111111110
1111111111111111111111111111111111111111111111111111111111111111111111111111111111111111111111111110
1111111111111111111111111111111111111111111111111111111111111111111111111111111111111111111111111110
