0000000000000000000000000000000000000000000000000000000000000000000000000000000000000000000000000000
1111111111111111111111111111111111111111111111111111111111111111111111111111111111111111111111111110
1111111111111111111111111111111111111111111111111111111111111111111111111111111111111111111111111110
1111111111111111111111111111111111111111111111111111111111111111111111111111111111111111111111111110
1111111111111111111111111111111111111111111111111111111111111111111111111111111111111111111111111110
1111111111111111111111111111111111111111111111111111111111111111111111111111111111111111111111111110
1111111111111111111111111111111111111111111111000000001111111111111111111111111111111111111111111110
1111111111111111111111111111111111111111111111000000001111111111111111111111111111111111111111111110
1111111111111111111111111111111111111111111111000000001111111111111111111111111111111111111111111110
1111111111111111111111111111111111111111111111000000001111111111111111111111111111111111111111111110
1111111111111111111111111111111111111111111111000000001111111111111111111111111111111111111111111110
1111111111111111111111111111111111111111111111000000001111111111111111111111111111111111111111111110
1111111111111111111111111111111111111111111111000000001111111111111111111111111111111111111111111110
1111111111111111111111111111111111111111111111000000001111111111111111111111111111111111111111111110
1111111111111111111111111111111111111111111111000000001111111111111111111111111111111111111111111110
1111111111111111111111111111111111111111111111000000001111111111111111111111111111111111111111111110
1111111111111111111111111111111111111111111111000000001111111111111111111111111111111111111111111110
1111111111111111111111111111111111111111111111000000001111111111111111111111111111111111111111111110
1111111111111111111111111111111111111111111111000000001111111111111111111111111111111111111111111110
1111111111111111111111111111111111111111111111000000001111111111111111111111111111111111111111111110
1111111111111111111111111111111111111111111111000000001111111111111111111111111111111111111111111110
1111111111111111111111111111111111111111111111000000001111111111111111111111111111111111111111111110
1111111111111111111111111111111111111111111111000000001111111111111111111111111111111111111111111110
1111111111111111111111111111111111111111111111000000001111111111111111111111111111111111111111111110
1111111111111111111111111111111111111111111111000000001111111111111111111111111111111111111111111110
1111111111111111111111111111111111111111111111000000001111111111111111111111111111111111111111111110
1111111111111111111111111111111111111111110000000000000000111111111111111111111111111111111111111110
1111111111111111111111111111111111111111110110000000000110111111111111111111111111111111111111111110
1111111111111111111111111111111111111100000110000000000110000011111111111111111111111111111111111110
1111111111111111111111111111111111111100000000000000000000000011111111111111111111111111111111111110
1111111111111111111111111111111111110000000000000000000000000000111111111111111111111111111111111110
1111111111111111111111111111111111110000000000000000000000000000111111111111111111111111111111111110
1111111111111111111111111111111111000000000000000000000000000000001111111111111111111111111111111110
1111111111111111111111111111111111000000000000000000000000000000001111111111111111111111111111111110
1111111111111111111111111111111100000000000000000000000000000000000011111111111111111111111111111110
1111111111111111111111111111111100000000000000000000000000000000000011111111111111111111111111111110
1111111111111111111111111111110000000000000000000000000000000000000000111111111111111111111111111110
1111111111111111111111111111110000000000000000000000000000000000000000111111111111111111111111111110
1111111111111111111111111111000000000000000000000000000000000000000000001111111111111111111111111110
1111111111111111111111111111000000000000000000000000000000000000000000001111111111111111111111111110
1111111111111111111111111100000000000000000000000000000000000000000000000011111111111111111111111110
1111111111111111111111111101100000000000000000000000000000000000000000011011111111111111111111111110
1111111111111111111111111101100000000000000000000000000000000000000000011011111111111111111111111110
1111111111111111111111111100000000000000000000000000000000000000000000000011111111111111111111111110
1111111111111111111111111100000000000000000000000000000000000000000000000011111111111111111111111110
1111111111111111111111111100000000000000000000000000000000000000000000000011111111111111111111111110
1111110000000000000000000000000000000000000000000000000000000000000000000000000000000000000000111110
1111110000000000000000000000000000000000000000000000000000000000000000000000000000000000000000111110
1111110000000000000000000000000000000000000000000000000000000000000000000000000000000000000000111110
1111110000000000000000000000000000000000000000000000000000000000000000000000000000000000000000111110
1111110000000000000000000000000000000000000000000000000000000000000000000000000000000000000000111110
1111110000000000000000000000000000000000000000000000000000000000000000000000000000000000000000111110
1111110000000000000000000000000000000000000000000000000000000000000000000000000000000000000000111110
1111110000000000000000000000000000000000000000000000000000000000000000000000000000000000000000111110
1111111111111111111111111100000000000000000000000000000000000000000000000011111111111111111111111110
1111111111111111111111111100000000000000000000000000000000000000000000000011111111111111111111111110
1111111111111111111111111100000000000000000000000000000000000000000000000011111111111111111111111110
1111111111111111111111111101100000000000000000000000000000000000000000011011111111111111111111111110
1111111111111111111111111101100000000000000000000000000000000000000000011011111111111111111111111110
1111111111111111111111111100000000000000000000000000000000000000000000000011111111111111111111111110
1111111111111111111111111111000000000000000000000000000000000000000000001111111111111111111111111110
1111111111111111111111111111000000000000000000000000000000000000000000001111111111111111111111111110
1111111111111111111111111111110000000000000000000000000000000000000000111111111111111111111111111110
1111111111111111111111111111110000000000000000000000000000000000000000111111111111111111111111111110
1111111111111111111111111111111100000000000000000000000000000000000011111111111111111111111111111110
1111111111111111111111111111111100000000000000000000000000000000000011111111111111111111111111111110
1111111111111111111111111111111111000000000000000000000000000000001111111111111111111111111111111110
1111111111111111111111111111111111000000000000000000000000000000001111111111111111111111111111111110
1111111111111111111111111111111111110000000000000000000000000000111111111111111111111111111111111110
1111111111111111111111111111111111110000000000000000000000000000111111111111111111111111111111111110
1111111111111111111111111111111111111100000000000000000000000011111111111111111111111111111111111110
1111111111111111111111111111111111111100000110000000000110000011111111111111111111111111111111111110
1111111111111111111111111111111111111111110110000000000110111111111111111111111111111111111111111110
1111111111111111111111111111111111111111110000000000000000111111111111111111111111111111111111111110
1111111111111111111111111111111111111111111111000000001111111111111111111111111111111111111111111110
1111111111111111111111111111111111111111111111000000001111111111111111111111111111111111111111111110
1111111111111111111111111111111111111111111111000000001111111111111111111111111111111111111111111110
1111111111111111111111111111111111111111111111000000001111111111111111111111111111111111111111111110
1111111111111111111111111111111111111111111111000000001111111111111111111111111111111111111111111110
1111111111111111111111111111111111111111111111000000001111111111111111111111111111111111111111111110
1111111111111111111111111111111111111111111111000000001111111111111111111111111111111111111111111110
1111111111111111111111111111111111111111111111000000001111111111111111111111111111111111111111111110
1111111111111111111111111111111111111111111111000000001111111111111111111111111111111111111111111110
1111111111111111111111111111111111111111111111000000001111111111111111111111111111111111111111111110
1111111111111111111111111111111111111111111111000000001111111111111111111111111111111111111111111110
1111111111111111111111111111111111111111111111000000001111111111111111111111111111111111111111111110
1111111111111111111111111111111111111111111111000000001111111111111111111111111111111111111111111110
1111111111111111111111111111111111111111111111000000001111111111111111111111111111111111111111111110
1111111111111111111111111111111111111111111111000000001111111111111111111111111111111111111111111110
1111111111111111111111111111111111111111111111000000001111111111111111111111111111111111111111111110
1111111111111111111111111111111111111111111111000000001111111111111111111111111111111111111111111110
1111111111111111111111111111111111111111111111000000001111111111111111111111111111111111111111111110
1111111111111111111111111111111111111111111111000000001111111111111111111111111111111111111111111110
1111111111111111111111111111111111111111111111000000001111111111111111111111111111111111111111111110
1111111111111111111111111111111111111111111111111111111111111111111111111111111111111111111111111110
1111111111111111111111111111111111111111111111111111111111111111111111111111111111111111111111111110
1111111111111111111111111111111111111111111111111111111111111111111111111111111111111111111111111110
1111111111111111111111111111111111111111111111111111111111111111111111111111111111111111111111111110
1111111111111111111111111111111111111111111111111111111111111111111111111111111111111111111111111110
1111111111111111111111111111111111111111111111111111111111111111111111111111111111111111111111111110
