0000000000000000000000000000000000000000000000000000000000000000000000000000000000000000000000000000
1111111111111111111111111111111111111111111111111111111111111111111111111111111111111111111111111110
1111111111111111111111111111111111111111111111111111111111111111111111111111111111111111111111111110
1111111111111111111111111111111111111111111111111111111111111111111111111111111111111111111111111110
1111111111111111111111111111111111111111111111110000111111111111111111111111111111111111111111111110
1111111111111111111111111111111111111111111111110000111111111111111111111111111111111111111111111110
1111111111111111111111111111111111111111111111000000001111111111111111111111111111111111111111111110
1111111111111111111111111111111111111111111111000000001111111111111111111111111111111111111111111110
1111111111111111111111111111111111111111111111000000001111111111111111111111111111111111111111111110
1111111111111111111111111111111111111111111111000000001111111111111111111111111111111111111111111110
1111111111111111111111111111111111111111111111110000111111111111111111111111111111111111111111111110
1111111111111111111111111111111111111111111111110000111111111111111111111111111111111111111111111110
1111111111111111111111111111111111111111111111110000111111111111111111111111111111111111111111111110
1111111111111111111111111111111111111111111111110000111111111111111111111111111111111111111111111110
1111111111111111111111111111111111111111111111110000111111111111111111111111111111111111111111111110
1111111111111111111111111111111111111111111111110000111111111111111111111111111111111111111111111110
1111111111111111111111111111111111111111111111110000111111111111111111111111111111111111111111111110
1111111111111111111111111111111111111111111111110000111111111111111111111111111111111111111111111110
1111111111111111111111111111111111111111111111110000111111111111111111111111111111111111111111111110
1111111111111111111111111111111111111111111111110000111111111111111111111111111111111111111111111110
1111111111111111111111111111111111111111111111110000111111111111111111111111111111111111111111111110
1111111111111111111111111111111111111111111111110000111111111111111111111111111111111111111111111110
1111111111111111111111111111111111111111111111110000111111111111111111111111111111111111111111111110
1111111111111111111111111111111111111111111111110000111111111111111111111111111111111111111111111110
1111111111111111111111111111111111111111111111110000111111111111111111111111111111111111111111111110
1111111111111111111111111111111111111111111111110000111111111111111111111111111111111111111111111110
1111111111111111111111111111111111111111111111000000001111111111111111111111111111111111111111111110
1111111111111111111111111111111111111111111111000000001111111111111111111111111111111111111111111110
1111111111111111111111111111111100000000000000000000000000000000000011111111111111111111111111111110
1111111111111111111111111111111100000000000000000000000000000000000011111111111111111111111111111110
1111111111111111111111111111110000000000000000000000000000000000000001111111111111111111111111111110
1111111111111111111111111111110000000000000000000000000000000000000011111111111111111111111111111110
1111111111111111111111111111000000000000000000000000000000000000000110001111111111111111111111111110
1111111111111111111111111111000000000000000000000000000000000000001100001111111111111111111111111110
1111111111111111111111111111000000001111111111110000111111111111011000001111111111111111111111111110
1111111111111111111111111111000000001111111111110000111111111111110000001111111111111111111111111110
1111111111111111111111111111000000111100000000000000000000000011110000001111111111111111111111111110
1111111111111111111111111111000000111100000000000000000000000011110000001111111111111111111111111110
1111111111111111111111111111000000110000000000000000000000000000110000001111111111111111111111111110
1111111111111111111111111111000000110000000000000000000000000000110000001111111111111111111111111110
1111111111111111111111111111000000110000000055000000005500000000110000001111111111111111111111111110
1111111111111111111111111111000000110000000055000000005500000000110000001111111111111111111111111110
1111111111111111111111111111000000110000005555000000005555000000110000001111111111111111111111111110
1111111111111111111111111111000000110000005555000000005555000000110000001111111111111111111111111110
1111111111111111111111111111000000110000555500000000000055550000110000001111111111111111111111111110
1111111111111111111111111111000000110000555500000000000055550000110000001111111111111111111111111110
1111110000111111111111111100000000110000000000000000000000000000110000000011111111111111110000111110
1111110000111111111111111100000000110000000000000000000000000000110000000011111111111111110000111110
1111000000000000000000000000000000000000000000000000000000000000000000000000000000000000000000001110
1111000000000000000000000000000000000000000000000000000000000000000000000000000000000000000000001110
1111000000000000000000000000000000000000000000000000000000000000000000000000000000000000000000001110
1111000000000000000000000000000000000000000000000000000000000000000000000000000000000000000000001110
1111110000111111111111111100000000110000000000000000000000000000110000000011111111111111110000111110
1111110000111111111111111100000000110000000000000000000000000000110000000011111111111111110000111110
1111111111111111111111111111000000110000555500000000000055550000110000001111111111111111111111111110
1111111111111111111111111111000000110000555500000000000055550000110000001111111111111111111111111110
1111111111111111111111111111000000110000005555000000005555000000110000001111111111111111111111111110
1111111111111111111111111111000000110000005555000000005555000000110000001111111111111111111111111110
1111111111111111111111111111000000110000000055000000005500000000110000001111111111111111111111111110
1111111111111111111111111111000000110000000055000000005500000000110000001111111111111111111111111110
1111111111111111111111111111000000110000000000000000000000000000110000001111111111111111111111111110
1111111111111111111111111111000000110000000000000000000000000000110000001111111111111111111111111110
1111111111111111111111111111000000111100000000000000000000000011110000001111111111111111111111111110
1111111111111111111111111111000000111100000000000000000000000011110000001111111111111111111111111110
1111111111111111111111111111000000111111111111110000111111111111000000001111111111111111111111111110
1111111111111111111111111111000001101111111111110000111111111111000000001111111111111111111111111110
1111111111111111111111111111000011000000000000000000000000000000000000001111111111111111111111111110
1111111111111111111111111111000110000000000000000000000000000000000000001111111111111111111111111110
1111111111111111111111111111111100000000000000000000000000000000000000111111111111111111111111111110
1111111111111111111111111111111000000000000000000000000000000000000000111111111111111111111111111110
1111111111111111111111111111111100000000000000000000000000000000000011111111111111111111111111111110
1111111111111111111111111111111100000000000000000000000000000000000011111111111111111111111111111110
1111111111111111111111111111111111111111111111000000001111111111111111111111111111111111111111111110
1111111111111111111111111111111111111111111111000000001111111111111111111111111111111111111111111110
1111111111111111111111111111111111111111111111110000111111111111111111111111111111111111111111111110
1111111111111111111111111111111111111111111111110000111111111111111111111111111111111111111111111110
1111111111111111111111111111111111111111111111110000111111111111111111111111111111111111111111111110
1111111111111111111111111111111111111111111111110000111111111111111111111111111111111111111111111110
1111111111111111111111111111111111111111111111110000111111111111111111111111111111111111111111111110
1111111111111111111111111111111111111111111111110000111111111111111111111111111111111111111111111110
1111111111111111111111111111111111111111111111110000111111111111111111111111111111111111111111111110
1111111111111111111111111111111111111111111111110000111111111111111111111111111111111111111111111110
1111111111111111111111111111111111111111111111110000111111111111111111111111111111111111111111111110
1111111111111111111111111111111111111111111111110000111111111111111111111111111111111111111111111110
1111111111111111111111111111111111111111111111110000111111111111111111111111111111111111111111111110
1111111111111111111111111111111111111111111111110000111111111111111111111111111111111111111111111110
1111111111111111111111111111111111111111111111110000111111111111111111111111111111111111111111111110
1111111111111111111111111111111111111111111111110000111111111111111111111111111111111111111111111110
1111111111111111111111111111111111111111111111110000111111111111111111111111111111111111111111111110
1111111111111111111111111111111111111111111111110000111111111111111111111111111111111111111111111110
1111111111111111111111111111111111111111111111000000001111111111111111111111111111111111111111111110
1111111111111111111111111111111111111111111111000000001111111111111111111111111111111111111111111110
1111111111111111111111111111111111111111111111000000001111111111111111111111111111111111111111111110
1111111111111111111111111111111111111111111111000000001111111111111111111111111111111111111111111110
1111111111111111111111111111111111111111111111110000111111111111111111111111111111111111111111111110
1111111111111111111111111111111111111111111111110000111111111111111111111111111111111111111111111110
1111111111111111111111111111111111111111111111111111111111111111111111111111111111111111111111111110
1111111111111111111111111111111111111111111111111111111111111111111111111111111111111111111111111110
1111111111111111111111111111111111111111111111111111111111111111111111111111111111111111111111111110
1111111111111111111111111111111111111111111111111111111111111111111111111111111111111111111111111110
