00000000000000000000000000000000000000000000000000000000000000000000000000000000000000000000000000000000000000000000000000000000000000000000
11111111111111111111111111111111111111111111111111111111111111111111111111111111111111111111111111111111111111111111111111111111111111111110
11111111111111111111111111111111111111111111111111111111111111111111111111111111111111111111111111111111111111111111111111111111111111111110
11111111111111111111111111111111111111111111111111111111111111111111111111111111111111111111111111111111111111111111111111111111111111111110
11111111111111111111111111111111111111111111111111111111111111110000000000001111111111111111111111111111111111111111111111111111111111111110
11111111111111111111111111111111111111111111111111111111111111110000000000001111111111111111111111111111111111111111111111111111111111111110
11111111111111111111111111111111111111111111111111111111111111110000000000001111111111111111111111111111111111111111111111111111111111111110
11111111111111111111111111111111111111111111111111111111111111110000000000001111111111111111111111111111111111111111111111111111111111111110
11111111111111111111111111111001110000111111111111111111111111110000000000001111111111111111110000110000001010000011111111111111111111111110
11111111111111111111111111111100100000111111111111111111111111110000000000001111111111111111110000011100000010000011111111111111111111111110
11111111111111111111111111111100000001111111111111111111111111110000000000001111111111111111110010011100000011000011111111111111111111111110
11111111111111111111111111111100000011111111111111111111111111110000000000001111111111111111110110111000000011100011111111111111111111111110
11111111111111111111111111110000001110111111111111111111111111110000000000001111111111111111110111110000111111100111111111111111111111111110
11111111111111111111111111000000011100111111111111111111111111110000000000001111111111111111110111100001111111100011111111111111111111111110
11111111111111111111111111000000110000111111111111111111111111110000000000001111111111111111110111110001110011100011111111111111111111111110
11111111111111111111111111000000100000111111111111111111111111110000000000001111111111111111110001100000000001100011111111111111111111111110
11111111111111111111111111000000000000111111111111111111111111110000000000001111111111111111110000000000000000100011111111111111111111111110
11111111111111111111111111000000000000011111111111111111111111111100000000111111111111111111111111111000000000000011111111111111111111111110
11111111111111111111111111000000000000000000000000000000000000000000000000000000000000000000000000000000000000000011111111111111111111111110
11111111111111111111111111000000000000000000000000000000000000000000000000000000000000000000000000000000000000000011111111111111111111111110
11111111111111111111111111000000000000000000000000000000000000000000000000000000000000000000000000000000000000000011111111111111111111111110
11111111111111111111111111001100000000000000000000000000000000000000000000000000000000000000000000000000000000000011111111111111111111111110
11111111111111111111111111111100000000000000000000000000000000000000000000000000000000000000000000000000000000000011111111111111111111111110
11111111111111111111111111011000000000000000000000000000000000000000000000000000000000000000000000000000000000000011111111111111111111111110
11111111111111111111111111011000000000000000000000000000000000000000000000000000000000000000000000000000000000000011111111111111111111111110
11111111111111111111111111000000000000000000000000000000000000000000000000000000000000000000000000000000000000000011111111111111111111111110
11111111111111111111111111000000000000000000000000000000000000000000000000000000000000000000000000000000000000000011111111111111111111111110
11111111111111111111111111000000000111000000000000000000000000000000000000000000000000000000000000000000000000000011111111111111111111111110
11111111111111111111111111000000000111111111111111111111111111111100000000111111111111111111111111111110000000000011111111111111111111111110
11111111111111111111111111000000000111111111111111111111111111111100000000111111111111111111111111111110000000000011111111111111111111111110
11111111111111111111111111000000000011111111111111111111111111111100000000111111111111111111111111111110000000000011111111111111111111111110
11111111111111111111111111000000000011111111111111111111111111111100000000111111111111111111111111111100000000000011111111111111111111111110
11111111111111111111111111000000000011111111111111000000000000000000000000000000000000001111111111111100000000000011111111111111111111111110
11111111111111111111111111000000000000111111111110000000000000000000000000000000000000000111111111111100000000000011111111111111111111111110
11111111111111111111111111110000000001111111111100000000000000000000000000000000000000000011111111111110000000000011111111111111111111111110
11111111111111111111111111111000000001111111111100000000000000000000000000000000000000000001111111111110000000000011111111111111111111111110
11111111111111111111111111111000000001111111111100000000000001100000000000011000000000000001111111111110000000000011111111111111111111111110
11111111111111111111111111100000000001111111111100000011000001100000000000011000001100000001111111111110000000000111111111111111111111111110
11111111111111111111111111000000000001111111111100000011111111111111111111111111111100000001111111111110000000000000111111111111111111111110
11111111111111111111111111000000000001111111111100000001111111111111111111111111111000000001111111111110000000000000111111111111111111111110
11111111111111111111111100000000000001111111111000000001111111111111111111111111111000000000111111111110000000000000111111111111111111111110
11111111111111111111111100000000000001111111110000000001111111111111111111111111111000000000011111111110000000000000111111111111111111111110
11111111111111111111111100000000000001111100000000000001111111111111111111111111111000000000000000111110000000000000111111111111111111111110
11111111111111111111111100000000000001111100000000001111111111111111111111111111111110000000000000111110000000000000111111111111111111111110
11111111111111111111111100000000000001111100000000001111111111111111111111111111111110000000000000111110000000000000111111111111111111111110
11111111111111111111111100000000000011111100000000000011111111111111111111111111111100000000000000111100000000000000111111111111111111111110
11111111111111111111111100100000011110111100000000000111111111111111111111111111111110000000000000111100000000000111111111111111111111111110
11111111111111111111111100000000111110111110000011101111111111111111111111111111111111001100000111111100000000000011111111111111111111111110
11111111111111111111111111000000111110111110000011111111111111111111111111111111111111101100000111111100000000000011111111111111111111111110
11111111111111111111111111000000111110111111111111111111111111111111111111111111111111111111111111111100000000000011111111111111111111111110
11111111111111111111111111000000011100111111111111111111111111111111111111111111111111111111111111111100000000000011111111111111111111111110
11111111111111111111111111000000000000111111111111111111111111111111111111111111111111111111111111111100000000000011111111111111111111111110
11111111111111111111111111000000000000111111111111111111111111111111111111111111111111111111111111111100000000000011111111111111111111111110
11111111111111111111111111000000000000111111111111111111111111111111111111111111111111111111111111111100000000000011111111111111111111111110
11111111111111111111111111100000000001111111111111111111111111111111111111111111111111111111111111111110000000000111111111111111111111111110
11111111111111111111111111000000000000111111111111111111111111111111111111111111111111111111111111111100000000000011111111111111111111111110
11111111111111111111111111000000000000111111111111111111111111111111111111111111111111111111111111111100000000000011111111111111111111111110
11111111111111111111111111000000000000111111111111111111111111111111000111111111111111111111111111111100000000000011111111111111111111111110
11111111111111111111111111000000001111111111111111111111111111111111000111111111111111111111111111111111110000000011111111111111111111111110
11111111111111111111111111000000000000001111111111111111111111111111000111111111111111111000000011110000000000000011111111111111111111111110
11111111111111111111111111000000000000001111111111111111111111111000000000111111111111111000000011110000000000000011111111111111111111111110
11111111111111111111111111000000000000001100000000001111111111111000000000111111111111111000000011110000000000000011111111111111111111111110
11111111111111111111111111000000000000001100000000001111111111111000000000111111111111111000000011110000000000000011111111111111111111111110
11111111111111111111111111000000000000001100000000001111111111111111000111111111111111111000000011110000000000000011111111111111111111111110
11111111111111111111111111000000000000001100000000001111111110000001000100000111111111111000000011110000000000000011111111111111111111111110
11111111111111111111111111000000000000001100000000001111111110000001000100000111111111111000000011110000000000000011111111111111111111111110
11111111111111111111111111000000011111111100000000001111111111000001111100000111111111111000000011111111111000000011111111111111111111111110
11111111111111111111111111000000000000001100000000001111111111000000000000000111111111111000000011110000000000000011111111111111111111111110
11111111111111111111111111111111111111111100000000001111111111000000000000000000000000000000000000111111111111111111111111111111111111111110
11111111111111111111111111111111111111111100000000000000000000000000000000000000000000000000000000111111111111111111111111111111111111111110
11111111111111111111111111111111111111111100000000000000000000000000000000000000000000000000000000111111111111111111111111111111111111111110
11111111111111111111111111111111111111111100000000000000000000000000000000000000000000000000000000111111111111111111111111111111111111111110
11111111111111111111111111111111111111111100000000000000000000000000000000000000000000000000000000111111111111111111111111111111111111111110
11111111111111111111111111111111111111111111111111111111111110000000000000000001111111111111111111111111111111111111111111111111111111111110
11111111111111111111111111111111111111110000000000000000000010000000000000000001000000000000000000001111111111111111111111111111111111111110
11111111111111111111111111111111111111110000000000000000000011100000000000000111000000000000000000001111111111111111111111111111111111111110
11111111111111111111111111111111111111110000000000000000000000100000000000000100000000000000000000001111111111111111111111111111111111111110
11111111111111111111111111111111111111110000000000000000000000111000000000011100000000000000000000001111111111111111111111111111111111111110
11111111111111111111111111111111111111110000000000000000000000001000000000010000000000000000000000001111111111111111111111111111111111111110
11111111111111111111111111111111111111110000000000000000000000001000000000010000000000000000000000001111111111111111111111111111111111111110
11111111111111111111111111111111111111110000000000000000000000000000000000000000000000000000000000001111111111111111111111111111111111111110
11111111111111111111111111111111111111110000000000000000000000000000000000000000000000000000000000001111111111111111111111111111111111111110
11111111111111111111111111111111111111110000000000000000000000000000000000000000000000000000000000001111111111111111111111111111111111111110
11111111111111111111111111111111111111110000000000000000000000000000000000000000000000000000000000001111111111111111111111111111111111111110
11111111111111111111111111111111111111110000000000000000000000000000000000000000000000000000000000001111111111111111111111111111111111111110
11111111111111111111111111111111111111110000000000000000000000000000000000000000000000000000000000001111111111111111111111111111111111111110
11111111111111111111111111111111111111110000000000000000000000000000000000000000000000000000000000001111111111111111111111111111111111111110
11111111111111111111111111111111111111110000000000000000000000000000000000000000000000000000000000001111111111111111111111111111111111111110
11111111111111111111111111111111111111110000000000000000000000000000000000000000000000000000000000001111111111111111111111111111111111111110
11111111111111111111111111111111111111110000000000000000000000000000000000000000000000000000000000001111111111111111111111111111111111111110
11111111111111111111111111111111111111110000010000000000000000000000000000000000000000000000000000001111111111111111111111111111111111111110
11111111111111111111111111111111111111110000010000000000000000000010000001000000000000000000001000001111111111111111111111111111111111111110
11111111111111111111111111111111111111110000010000000000000000000010000001000000000000000000001000001111111111111111111111111111111111111110
11111111111111111111111111111111111111110000010000000000000000000010000001000000000000000000001000001111111111111111111111111111111111111110
11111111111111111111111111111111111111110000010000000000000000000010000001000000000000000000001000001111111111111111111111111111111111111110
11111111111111111111111111111111111111110000010000000000000000000010000001000000000000000000001000001111111111111111111111111111111111111110
11111111111111111111111111111111111111110000010000000000000000000010000001000000000000000000001000001111111111111111111111111111111111111110
11111111111111111111111111111111111111110000010000000000000000000010000001000000000000000000001000001111111111111111111111111111111111111110
11111111111111111111111111111111111111110000010000000000000000000010000001000000000000000000001000001111111111111111111111111111111111111110
11111111111111111111111111111111111111110000010000000000000000000010000001000000000000000000001000001111111111111111111111111111111111111110
11111111111111111111111111111111111111110000010000000000000000000010000001000000000000000000001000001111111111111111111111111111111111111110
11111111111111111111111111111111111111110000010000000000000000000010000001000000000000000000001000001111111111111111111111111111111111111110
11111111111111111111111111111111111111110000010000000000000000000010000001000000000000000000001000001111111111111111111111111111111111111110
11111111111111111111111111111111111111110000010000000000000000000010000001000000000000000000001000001111111111111111111111111111111111111110
11111111111111111111111111111111111111110000010000000000000000000010000001000000000000000000001000001111111111111111111111111111111111111110
11111111111111111111111111111111111111110000010000000000000000000010000001000000000000000000001000001111111111111111111111111111111111111110
11111111111111111111111111111111111111110000010000000000000000000010000001000000000000000000001000001111111111111111111111111111111111111110
11111111111111111111111111111111111111110000010000000000000000000010000001000000000000000000001000001111111111111111111111111111111111111110
11111111111111111111111111111111111111110000010000000000000000000010000001000000000000000000001000001111111111111111111111111111111111111110
11111111111111111111111111111111111111110000010000000000000000000010000001000000000000000000001000001111111111111111111111111111111111111110
11111111111111111111111111111111111111110000010000000000000000000010000001000000000000000000001000001111111111111111111111111111111111111110
11111111111111111111111111111111111111110000010000000000000000000010000001000000000000000000001000001111111111111111111111111111111111111110
11111111111111111111111111111111111111110000010000000000000000000010000001000000000000000000001000001111111111111111111111111111111111111110
11111111111111111111111111111111111111110000010000000000000000000010000001000000000000000000001000001111111111111111111111111111111111111110
11111111111111111111111111111111111111110000010000000000000000000010000001000000000000000000001000001111111111111111111111111111111111111110
11111111111111111111111111111111111111110000010000000000000000000010000001000000000000000000001000001111111111111111111111111111111111111110
11111111111111111111111111111111111111110000010000000000000000000010000001000000000000000000001000001111111111111111111111111111111111111110
11111111111111111111111111111111111111110000010000000000000000000010000001000000000000000000001000001111111111111111111111111111111111111110
11111111111111111111111111111111111111110000010000000000000000000010000001000000000000000000001000001111111111111111111111111111111111111110
11111111111111111111111111111111111111110000010000000000000000000010000001000000000000000000001000001111111111111111111111111111111111111110
11111111111111111111111111111111111111110000010000000000000000000010000001000000000000000000001000001111111111111111111111111111111111111110
11111111111111111111111111111111111111110000010000000000000000000010000001000000000000000000001000001111111111111111111111111111111111111110
11111111111111111111111111111111111111110000010000000000000000000010000001000000000000000000001000001111111111111111111111111111111111111110
11111111111111111111111111111111111111110000010000000000000000000010000001000000000000000000001000001111111111111111111111111111111111111110
11111111111111111111111111111111111111110000010000000000000000000000000000000000000000000000001000001111111111111111111111111111111111111110
11111111111111111111111111111111111111110000010000000000000000000000000000000000000000000000001000001111111111111111111111111111111111111110
11111111111111111111111111111111111111110000010000000000000000000000000000000000000000000000001000001111111111111111111111111111111111111110
11111111111111111111111111111111111111110000010000000000000000000000000000000000000000000000000000001111111111111111111111111111111111111110
11111111111111111111111111111111111111110000000000000000000000000000000000000000000000000000000000001111111111111111111111111111111111111110
11111111111111111111111111111111111111110000000000000000000000000000000000000000000000000000000000001111111111111111111111111111111111111110
11111111111111111111111111111111111111110000000000000000000000000000000000000000000000000000000000001111111111111111111111111111111111111110
11111111111111111111111111111111111111110000000000000000000000000000000000000000000000000000000000001111111111111111111111111111111111111110
11111111111111111111111111111111111111111111111111111111111111111111111111111111111111111111111111111111111111111111111111111111111111111110
11111111111111111111111111111111111111111111111111111111111111111111111111111111111111111111111111111111111111111111111111111111111111111110
11111111111111111111111111111111111111111111111111111111111111111111111111111111111111111111111111111111111111111111111111111111111111111110
11111111111111111111111111111111111111111111111111111111111111111111111111111111111111111111111111111111111111111111111111111111111111111110
11111111111111111111111111111111111111111111111111111111111111111111111111111111111111111111111111111111111111111111111111111111111111111110
11111111111111111111111111111111111111111111111111111111111111111111111111111111111111111111111111111111111111111111111111111111111111111110
11111111111111111111111111111111111111111111111111111111111111111111111111111111111111111111111111111111111111111111111111111111111111111110
11111111111111111111111111111111111111111111111111111111111111111111111111111111111111111111111111111111111111111111111111111111111111111110
11111111111111111111111111111111111111111111111111111111111111111111111111111111111111111111111111111111111111111111111111111111111111111110
11111111111111111111111111111111111111111111111111111111111111111111111111111111111111111111111111111111111111111111111111111111111111111110
11111111111111111111111111111111111111111111111111111111111111111111111111111111111111111111111111111111111111111111111111111111111111111110
11111111111111111111111111111111111111111111111111111111111111111111111111111111111111111111111111111111111111111111111111111111111111111110
11111111111111111111111111111111111111111111111111111111111111111111111111111111111111111111111111111111111111111111111111111111111111111110
11111111111111111111111111111111111111111111111111111111111111111111111111111111111111111111111111111111111111111111111111111111111111111110
11111111111111111111111111111111111111111111111111111111111111111111111111111111111111111111111111111111111111111111111111111111111111111110
11111111111111111111111111111111111111111111111111111111111111111111111111111111111111111111111111111111111111111111111111111111111111111110
11111111111111111111111111111111111111111111111111111111111111111111111111111111111111111111111111111111111111111111111111111111111111111110
11111111111111111111111111111111111111111111111111111111111111111111111111111111111111111111111111111111111111111111111111111111111111111110
11111111111111111111111111111111111111111111111111111111111111111111111111111111111111111111111111111111111111111111111111111111111111111110
11111111111111111111111111111111111111111111111111111111111111111111111111111111111111111111111111111111111111111111111111111111111111111110
11111111111111111111111111111111111111111111111111111111111111111111111111111111111111111111111111111111111111111111111111111111111111111110
11111111111111111111111111111111111111111111111111111111111111111111111111111111111111111111111111111111111111111111111111111111111111111110
11111111111111111111111111111111111111111111111111111111111111111111111111111111111111111111111111111111111111111111111111111111111111111110
11111111111111111111111111111111111111111111111111111111111111111111111111111111111111111111111111111111111111111111111111111111111111111110
11111111111111111111111111111111111111111111111111111111111111111111111111111111111111111111111111111111111111111111111111111111111111111110
11111111111111111111111111111111111111111111111111111111111111111111111111111111111111111111111111111111111111111111111111111111111111111110
11111111111111111111111111111111111111111111111111111111111111111111111111111111111111111111111111111111111111111111111111111111111111111110
11111111111111111111111111111111111111111111111111111111111111111111111111111111111111111111111111111111111111111111111111111111111111111110
11111111111111111111111111111111111111111111111111111111111111111111111111111111111111111111111111111111111111111111111111111111111111111110
11111111111111111111111111111111111111111111111111111111111111111111111111111111111111111111111111111111111111111111111111111111111111111110
11111111111111111111111111111111111111111111111111111111111111111111111111111111111111111111111111111111111111111111111111111111111111111110
11111111111111111111111111111111111111111111111111111111111111111111111111111111111111111111111111111111111111111111111111111111111111111110
11111111111111111111111111111111111111111111111111111111111111111111111111111111111111111111111111111111111111111111111111111111111111111110
11111111111111111111111111111111111111111111111111111111111111111111111111111111111111111111111111111111111111111111111111111111111111111110
11111111111111111111111111111111111111111111111111111111111111111111111111111111111111111111111111111111111111111111111111111111111111111110
11111111111111111111111111111111111111111111111111111111111111111111111111111111111111111111111111111111111111111111111111111111111111111110
11111111111111111111111111111111111111111111111111111111111111111111111111111111111111111111111111111111111111111111111111111111111111111110
11111111111111111111111111111111111111111111111111111111111111111111111111111111111111111111111111111111111111111111111111111111111111111110
11111111111111111111111111111111111111111111111111111111111111111111111111111111111111111111111111111111111111111111111111111111111111111110
11111111111111111111111111111111111111111111111111111111111111111111111111111111111111111111111111111111111111111111111111111111111111111110
