0000000000000000000000000000000000000000000000000000000000000000000000000000000000000000000000000000
1111111111111111111111111111111111111111111111111111111111111111111111111111111111111111111111111110
1111111111111111111111111111111111111111111111111111111111111111111111111111111111111111111111111110
1111111111111111111111111111111111111111111111111111111111111111111111111111111111111111111111111110
1111111111111111111111111111111111111111111111111111111111111111111111111111111111111111111111111110
1111111111111111111111111111111111111111111111111111111111111111111111111111111111111111111111111110
1111111111111111111111111111111111111111111111111111111111111111111111111111111111111111111111111110
1111111111111111111111111111111111111111111111111111111111111111111111111111111111111111111111111110
1111111111111111111111111111111111111111111111111111111111111111111111111111111111111111111111111110
1111111111111111111111111111111111111111111111111111111111111111111111111111111111111111111111111110
1111111111111111111111111111111111111111111111111111111111111111111111111111111111111111111111111110
1111111111111111111111111111111111111111111111111111111111111111111111111111111111111111111111111110
1111111111111111111111111111111111111111111111111111111111111111111111111111111111111111111111111110
1111111111111111111111111111111111111111111111111111111111111111111111111111111111111111111111111110
1111111111111111111111111111111111111111111111111111111111111111111111111111111111111111111111111110
1111111111111111111111111111111111111111111111111111111111111111111111111111111111111111111111111110
1111111111111111111111111111111111111111111111111111111111111111111111111111111111111111111111111110
1111111111111111111111111111111111111111111111111111111111111111111111111111111111111111111111111110
1111111111111111111111111111111111111111111111111111111111111111111111111111111111111111111111111110
1111111111111111111111111111111111111111111111111111111111111111111111111111111111111111111111111110
1111111111111111111111111111111111111111111111111111111111111111111111111111111111111111111111111110
1111111111111111111111111111111111111111111111111111111111111111111111111111111111111111111111111110
1111111111111111111111111111111111111111111111111111111111111111111111111111111111111111111111111110
1111111111111111111111111111111111111111111111111111111111111111111111111111111111111111111111111110
1111111111111111111111111111111111111111111111111111111111111111111111111111111111111111111111111110
1111111111111111111111111111111111111111111111111111111111111111111111111111111111111111111111111110
1111111111111111111111111111111111111111111111111111111111111111111111111111111111111111111111111110
1111111111111111111111111111111111111111111111111111111111111111111111111111111111111111111111111110
1111111111111111111111111111111111111111111111000000001111111111111111111111111111111111111111111110
1111111111111111111111111111111111111111111111000000001111111111111111111111111111111111111111111110
1111111111111111111111111111111111111111111111000000001111111111111111111111111111111111111111111110
1111111111111111111111111111111111111111111111000000001111111111111111111111111111111111111111111110
1111111111111111111111111111111111111111111111000000001111111111111111111111111111111111111111111110
1111111111111111111111111111111111111111111111000000001111111111111111111111111111111111111111111110
1111111111111111111111111111111111111111111111000000001111111111111111111111111111111111111111111110
1111111111111111111111111111111111111111111111000000001111111111111111111111111111111111111111111110
1111111111111111111111111111111111111111111111000000001111111111111111111111111111111111111111111110
1111111111111111111111111111111111111111111111000000001111111111111111111111111111111111111111111110
1111111111111111111111111111111111111111111111000000001111111111111111111111111111111111111111111110
1111111111111111111111111111111111111111111111000000001111111111111111111111111111111111111111111110
1111111111111111111111111111111111111111111111000000001111111111111111111111111111111111111111111110
1111111111111111111111111111111111111111111111000000001111111111111111111111111111111111111111111110
1111111111111111111111111111111111111111111111000000001111111111111111111111111111111111111111111110
1111111111111111111111111111111111111111111111000000001111111111111111111111111111111111111111111110
1111111111111111111111111111111111111111111111000000001111111111111111111111111111111111111111111110
1111111111111111111111111111111111111111111111000000001111111111111111111111111111111111111111111110
1111111111111111111111111111111111111111111111000000001111111111111111111111111111111111111111111110
1111111111111111111111111111111111111111111111000000001111111111111111111111111111111111111111111110
1111111111111111111111111111111111111111111111000000001111111111111111111111111111111111111111111110
1111111111111111111111111111111111111111111111000000001111111111111111111111111111111111111111111110
1111111111111111111111111111000000000000000000000000000000000000000000001111111111111111111111111110
1111111111111111111111111111000000000000000000000000000000000000000000001111111111111111111111111110
1111111111111111111111111111000000000000000000000000000000000000000000001111111111111111111111111110
1111111111111111111111111111000000000000000000000000000000000000000000001111111111111111111111111110
1111111111111111111111111111000000000000000000000000000000000000000000001111111111111111111111111110
1111111111111111111111111111000000000000000000000000000000000000000000001111111111111111111111111110
1111111111111111111111111111000000000000000000000000000000000000000000001111111111111111111111111110
1111111111111111111111111111000000000000000000000000000000000000000000001111111111111111111111111110
1111111111111111111111111111111111111111111111000000001111111111111111111111111111111111111111111110
1111111111111111111111111111111111111111111111000000001111111111111111111111111111111111111111111110
1111111111111111111111111111111111111111111111000000001111111111111111111111111111111111111111111110
1111111111111111111111111111111111111111111111000000001111111111111111111111111111111111111111111110
1111111111111111111111111111111111111111111111000000001111111111111111111111111111111111111111111110
1111111111111111111111111111111111111111111111000000001111111111111111111111111111111111111111111110
1111111111111111111111111111111111111111111111000000001111111111111111111111111111111111111111111110
1111111111111111111111111111111111111111111111000000001111111111111111111111111111111111111111111110
1111111111111111111111111111111111111111111111111111111111111111111111111111111111111111111111111110
1111111111111111111111111111111111111111111111111111111111111111111111111111111111111111111111111110
1111111111111111111111111111111111111111111111111111111111111111111111111111111111111111111111111110
1111111111111111111111111111111111111111111111111111111111111111111111111111111111111111111111111110
1111111111111111111111111111111111111111111111111111111111111111111111111111111111111111111111111110
1111111111111111111111111111111111111111111111111111111111111111111111111111111111111111111111111110
1111111111111111111111111111111111111111111111111111111111111111111111111111111111111111111111111110
1111111111111111111111111111111111111111111111111111111111111111111111111111111111111111111111111110
1111111111111111111111111111111111111111111111111111111111111111111111111111111111111111111111111110
1111111111111111111111111111111111111111111111111111111111111111111111111111111111111111111111111110
1111111111111111111111111111111111111111111111111111111111111111111111111111111111111111111111111110
1111111111111111111111111111111111111111111111111111111111111111111111111111111111111111111111111110
1111111111111111111111111111111111111111111111111111111111111111111111111111111111111111111111111110
1111111111111111111111111111111111111111111111111111111111111111111111111111111111111111111111111110
1111111111111111111111111111111111111111111111111111111111111111111111111111111111111111111111111110
1111111111111111111111111111111111111111111111111111111111111111111111111111111111111111111111111110
1111111111111111111111111111111111111111111111111111111111111111111111111111111111111111111111111110
1111111111111111111111111111111111111111111111111111111111111111111111111111111111111111111111111110
1111111111111111111111111111111111111111111111111111111111111111111111111111111111111111111111111110
1111111111111111111111111111111111111111111111111111111111111111111111111111111111111111111111111110
1111111111111111111111111111111111111111111111111111111111111111111111111111111111111111111111111110
1111111111111111111111111111111111111111111111111111111111111111111111111111111111111111111111111110
1111111111111111111111111111111111111111111111111111111111111111111111111111111111111111111111111110
1111111111111111111111111111111111111111111111111111111111111111111111111111111111111111111111111110
1111111111111111111111111111111111111111111111111111111111111111111111111111111111111111111111111110
1111111111111111111111111111111111111111111111111111111111111111111111111111111111111111111111111110
1111111111111111111111111111111111111111111111111111111111111111111111111111111111111111111111111110
1111111111111111111111111111111111111111111111111111111111111111111111111111111111111111111111111110
1111111111111111111111111111111111111111111111111111111111111111111111111111111111111111111111111110
1111111111111111111111111111111111111111111111111111111111111111111111111111111111111111111111111110
1111111111111111111111111111111111111111111111111111111111111111111111111111111111111111111111111110
1111111111111111111111111111111111111111111111111111111111111111111111111111111111111111111111111110
1111111111111111111111111111111111111111111111111111111111111111111111111111111111111111111111111110
1111111111111111111111111111111111111111111111111111111111111111111111111111111111111111111111111110
1111111111111111111111111111111111111111111111111111111111111111111111111111111111111111111111111110
1111111111111111111111111111111111111111111111111111111111111111111111111111111111111111111111111110
1111111111111111111111111111111111111111111111111111111111111111111111111111111111111111111111111110
1111111111111111111111111111111111111111111111111111111111111111111111111111111111111111111111111110
1111111111111111111111111111111111111111111111111111111111111111111111111111111111111111111111111110
1111111111111111111111111111111111111111111111111111111111111111111111111111111111111111111111111110
1111111111111111111111111111111111111111111111111111111111111111111111111111111111111111111111111110
1111111111111111111111111111111111111111111111111111111111111111111111111111111111111111111111111110
1111111111111111111111111111111111111111111111111111111111111111111111111111111111111111111111111110
1111111111111111111111111111111111111111111111111111111111111111111111111111111111111111111111111110
1111111111111111111111111111111111111111111111111111111111111111111111111111111111111111111111111110
1111111111111111111111111111111111111111111111111111111111111111111111111111111111111111111111111110
1111111111111111111111111111111111111111111111111111111111111111111111111111111111111111111111111110
1111111111111111111111111111111111111111111111111111111111111111111111111111111111111111111111111110
1111111111111111111111111111111111111111111111111111111111111111111111111111111111111111111111111110
1111111111111111111111111111111111111111111111111111111111111111111111111111111111111111111111111110
1111111111111111111111111111111111111111111111111111111111111111111111111111111111111111111111111110
1111111111111111111111111111111111111111111111111111111111111111111111111111111111111111111111111110
1111111111111111111111111111111111111111111111111111111111111111111111111111111111111111111111111110
1111111111111111111111111111111111111111111111111111111111111111111111111111111111111111111111111110
1111111111111111111111111111111111111111111111111111111111111111111111111111111111111111111111111110
1111111111111111111111111111111111111111111111111111111111111111111111111111111111111111111111111110
1111111111111111111111111111111111111111111111111111111111111111111111111111111111111111111111111110
1111111111111111111111111111111111111111111111111111111111111111111111111111111111111111111111111110
1111111111111111111111111111111111111111111111111111111111111111111111111111111111111111111111111110
1111111111111111111111111111111111111111111111111111111111111111111111111111111111111111111111111110
1111111111111111111111111111111111111111111111111111111111111111111111111111111111111111111111111110
1111111111111111111111111111111111111111111111111111111111111111111111111111111111111111111111111110
1111111111111111111111111111111111111111111111111111111111111111111111111111111111111111111111111110
1111111111111111111111111111111111111111111111111111111111111111111111111111111111111111111111111110
1111111111111111111111111111111111111111111111111111111111111111111111111111111111111111111111111110
1111111111111111111111111111111111111111111111111111111111111111111111111111111111111111111111111110
1111111111111111111111111111111111111111111111111111111111111111111111111111111111111111111111111110
1111111111111111111111111111111111111111111111111111111111111111111111111111111111111111111111111110
1111111111111111111111111111111111111111111111111111111111111111111111111111111111111111111111111110
1111111111111111111111111111111111111111111111111111111111111111111111111111111111111111111111111110
1111111111111111111111111111111111111111111111111111111111111111111111111111111111111111111111111110
1111111111111111111111111111111111111111111111111111111111111111111111111111111111111111111111111110
1111111111111111111111111111111111111111111111111111111111111111111111111111111111111111111111111110
1111111111111111111111111111111111111111111111111111111111111111111111111111111111111111111111111110
1111111111111111111111111111111111111111111111111111111111111111111111111111111111111111111111111110
1111111111111111111111111111111111111111111111111111111111111111111111111111111111111111111111111110
1111111111111111111111111111111111111111111111111111111111111111111111111111111111111111111111111110
1111111111111111111111111111111111111111111111111111111111111111111111111111111111111111111111111110
1111111111111111111111111111111111111111111111000000001111111111111111111111111111111111111111111110
1111111111111111111111111111111111111111111111000000001111111111111111111111111111111111111111111110
1111111111111111111111111111111111111111111111000000001111111111111111111111111111111111111111111110
1111111111111111111111111111111111111111111111000000001111111111111111111111111111111111111111111110
1111111111111111111111111111111111111111111111000000001111111111111111111111111111111111111111111110
1111111111111111111111111111111111111111111111000000001111111111111111111111111111111111111111111110
1111111111111111111111111111111111111111111111000000001111111111111111111111111111111111111111111110
1111111111111111111111111111111111111111111111000000001111111111111111111111111111111111111111111110
1111111111111111111111111111111111111111111111000000001111111111111111111111111111111111111111111110
1111111111111111111111111111111111111111111111000000001111111111111111111111111111111111111111111110
1111111111111111111111111111111111111111111111000000001111111111111111111111111111111111111111111110
1111111111111111111111111111111111111111111111000000001111111111111111111111111111111111111111111110
1111111111111111111111111111111111111111111111000000001111111111111111111111111111111111111111111110
1111111111111111111111111111111111111111111111000000001111111111111111111111111111111111111111111110
1111111111111111111111111111111111111111111111000000001111111111111111111111111111111111111111111110
1111111111111111111111111111111111111111111111000000001111111111111111111111111111111111111111111110
1111111111111111111111111111111111111111111111000000001111111111111111111111111111111111111111111110
1111111111111111111111111111111111111111111111000000001111111111111111111111111111111111111111111110
1111111111111111111111111111111111111111111111000000001111111111111111111111111111111111111111111110
1111111111111111111111111111111111111111111111000000001111111111111111111111111111111111111111111110
1111111111111111111111111111111111111111111111000000001111111111111111111111111111111111111111111110
1111111111111111111111111111111111111111111111000000001111111111111111111111111111111111111111111110
1111111111111111111111111111000000000000000000000000000000000000000000001111111111111111111111111110
1111111111111111111111111111000000000000000000000000000000000000000000001111111111111111111111111110
1111111111111111111111111111000000000000000000000000000000000000000000001111111111111111111111111110
1111111111111111111111111111000000000000000000000000000000000000000000001111111111111111111111111110
1111111111111111111111111111000000000000000000000000000000000000000000001111111111111111111111111110
1111111111111111111111111111000000000000000000000000000000000000000000001111111111111111111111111110
1111111111111111111111111111000000000000000000000000000000000000000000001111111111111111111111111110
1111111111111111111111111111000000000000000000000000000000000000000000001111111111111111111111111110
1111111111111111111111111111111111111111111111000000001111111111111111111111111111111111111111111110
1111111111111111111111111111111111111111111111000000001111111111111111111111111111111111111111111110
1111111111111111111111111111111111111111111111000000001111111111111111111111111111111111111111111110
1111111111111111111111111111111111111111111111000000001111111111111111111111111111111111111111111110
1111111111111111111111111111111111111111111111000000001111111111111111111111111111111111111111111110
1111111111111111111111111111111111111111111111000000001111111111111111111111111111111111111111111110
1111111111111111111111111111111111111111111111000000001111111111111111111111111111111111111111111110
1111111111111111111111111111111111111111111111000000001111111111111111111111111111111111111111111110
1111111111111111111111111111111111111111111111111111111111111111111111111111111111111111111111111110
1111111111111111111111111111111111111111111111111111111111111111111111111111111111111111111111111110
1111111111111111111111111111111111111111111111111111111111111111111111111111111111111111111111111110
1111111111111111111111111111111111111111111111111111111111111111111111111111111111111111111111111110
1111111111111111111111111111111111111111111111111111111111111111111111111111111111111111111111111110
1111111111111111111111111111111111111111111111111111111111111111111111111111111111111111111111111110
1111111111111111111111111111111111111111111111111111111111111111111111111111111111111111111111111110
1111111111111111111111111111111111111111111111111111111111111111111111111111111111111111111111111110
1111111111111111111111111111111111111111111111111111111111111111111111111111111111111111111111111110
1111111111111111111111111111111111111111111111111111111111111111111111111111111111111111111111111110
1111111111111111111111111111111111111111111111111111111111111111111111111111111111111111111111111110
1111111111111111111111111111111111111111111111111111111111111111111111111111111111111111111111111110
1111111111111111111111111111111111111111111111111111111111111111111111111111111111111111111111111110
1111111111111111111111111111111111111111111111111111111111111111111111111111111111111111111111111110
1111111111111111111111111111111111111111111111111111111111111111111111111111111111111111111111111110
1111111111111111111111111111111111111111111111111111111111111111111111111111111111111111111111111110
1111111111111111111111111111111111111111111111111111111111111111111111111111111111111111111111111110
1111111111111111111111111111111111111111111111111111111111111111111111111111111111111111111111111110
