0000000000000000000000000000000000000000000000000000000000000000000000000000000000000000000000000000
1111111111111111111111111111111111111111111111111111111111111111111111111111111111111111111111111110
1111111111111111111111111111111111111111111111111111111111111111111111111111111111111111111111111110
1111111111111111111111111111111111111111111111111111111111111111111111111111111111111111111111111110
1111111111111111111111111111111111111111111111111111111111111111111111111111111111111111111111111110
1111111111111111111111111111111111111111111111111111111111111111111111111111111111111111111111111110
1111111111111111111111111111111111111111111111111111111111111111111111111111111111111111111111111110
1111111111111111111111111111111111111111111111111111111111111111111111111111111111111111111111111110
1111111111111111111111111111111111111111111111111111111111111111111111111111111111111111111111111110
1111111111111111111111111111111111111111111111111111111111111111111111111111111111111111111111111110
1111111111111111111111111111111111111111111111111111111111111111111111111111111111111111111111111110
1111111111111111111111111111111111111111111111111111111111111111111111111111111111111111111111111110
1111111111111111111111111111111111111111111111111111111111111111111111111111111111111111111111111110
1111111111111111111111111111111111111111111111111111111111111111111111111111111111111111111111111110
1111111111111111111111111111111111111111111111111111111111111111111111111111111111111111111111111110
1111111111111111111111111111111111111111111111111111111111111111111111111111111111111111111111111110
1111111111111111111111111111111111111111111111111111111111111111111111111111111111111111111111111110
1111111111111111111111111111111111111111111111111111111111111111111111111111111111111111111111111110
1111111111111111111111111111111111111111111111111111111111111111111111111111111111111111111111111110
1111111111111111111111111111111111111111111111111111111111111111111111111111111111111111111111111110
1111111111111111111111111111111111111111111111111111111111111111111111111111111111111111111111111110
1111111111111111111111111111111111111111111111111111111111111111111111111111111111111111111111111110
1111111111111111111111111111111111111111111111111111111111111111111111111111111111111111111111111110
1111111111111111111111111111111111111111111111111111111111111111111111111111111111111111111111111110
1111111111111111111111111111111111111111111111111111111111111111111111111111111111111111111111111110
1111111111111111111111111111111111111111111111111111111111111111111111111111111111111111111111111110
1111111111111111111111111111111111111111000000000000000000001111111111111111111111111111111111111110
1111111111111111111111111111111111111110000000000000000000000111111111111111111111111111111111111110
1111111111111111111111111111111111111100000000000000000000000011111111111111111111111111111111111110
1111111111111111111111111111111111111000000000000000000000000001111111111111111111111111111111111110
1111111111111111111111111111111111110000000000000000000000000000111111111111111111111111111111111110
1111111111111111111111111111111111100000000000000000000000000000011111111111111111111111111111111110
1111111111111111111111111111111111000000000000000000000000000000001111111111111111111111111111111110
1111111111111111111111111111111110000000000000000000000000000000000111111111111111111111111111111110
1111111111111111111111111111111100000000000000000000000000000000000011111111111111111111111111111110
1111111111111111111111111111111000000000000000000000000000000000000001111111111111111111111111111110
1111111111111111111111111111110000000000000000000000000000000000000000111111111111111111111111111110
1111111111111111111111111111100000000000000000000000000000000000000000011111111111111111111111111110
1111111111111111111111111111000000000000000000000000000000000000000000001111111111111111111111111110
1111111111111111111111111111000000000000000000000000000000000000000000001111111111111111111111111110
1111111111111111111111111111000000000000000000000000000000000000000000001111111111111111111111111110
1111111111111111111111111111000000000000000000000000000000000000000000001111111111111111111111111110
1111111111111111111111111111000000000000000055000000005500000000000000001111111111111111111111111110
1111111111111111111111111111000000000000000055000000005500000000000000001111111111111111111111111110
1111111111111111111111111111000000000000000000000000000000000000000000001111111111111111111111111110
1111111111111111111111111111000000000000000000000000000000000000000000001111111111111111111111111110
1111111111111111111111111111000000000000000000000000000000000000000000001111111111111111111111111110
1111111111111111111111111111000000000000000000000000000000000000000000001111111111111111111111111110
1111111111111111111111111111000000000000000000000000000000000000000000001111111111111111111111111110
1111111111111111111111111111000000000000000000000000000000000000000000001111111111111111111111111110
1111111111111111111111111111000000000000000000000000000000000000000000001111111111111111111111111110
1111111111111111111111111111000000000000000000000000000000000000000000001111111111111111111111111110
1111111111111111111111111111000000000000000055000000005500000000000000001111111111111111111111111110
1111111111111111111111111111000000000000000055000000005500000000000000001111111111111111111111111110
1111111111111111111111111111000000000000000000000000000000000000000000001111111111111111111111111110
1111111111111111111111111111000000000000000000000000000000000000000000001111111111111111111111111110
1111111111111111111111111111000000000000000000000000000000000000000000001111111111111111111111111110
1111111111111111111111111111000000000000000000000000000000000000000000001111111111111111111111111110
1111111111111111111111111111000000000000000000000000000000000000000000001111111111111111111111111110
1111111111111111111111111111100000000000000000000000000000000000000000011111111111111111111111111110
1111111111111111111111111111110000000000000000000000000000000000000000111111111111111111111111111110
1111111111111111111111111111111000000000000000000000000000000000000001111111111111111111111111111110
1111111111111111111111111111111100000000000000000000000000000000000011111111111111111111111111111110
1111111111111111111111111111111110000000000000000000000000000000000111111111111111111111111111111110
1111111111111111111111111111111111000000000000000000000000000000001111111111111111111111111111111110
1111111111111111111111111111111111100000000000000000000000000000011111111111111111111111111111111110
1111111111111111111111111111111111110000000000000000000000000000111111111111111111111111111111111110
1111111111111111111111111111111111111000000000000000000000000001111111111111111111111111111111111110
1111111111111111111111111111111111111100000000000000000000000011111111111111111111111111111111111110
1111111111111111111111111111111111111110000000000000000000000111111111111111111111111111111111111110
1111111111111111111111111111110000000000000000000000000000000000000000111111111111111111111111111110
1111111111111111111111111111110000000000000000000000000000000000000000111111111111111111111111111110
1111111111111111111111111111110000000000000000000000000000000000000000111111111111111111111111111110
1111111111111111111111111111110000000000000000000000000000000000000000111111111111111111111111111110
1111111111111111111111111111110000000000000000000000000000000000000000111111111111111111111111111110
1111111111111111111111111111111111000000000000000000000000000000001111111111111111111111111111111110
1111111111111111111111111111110000000000000000000000000000000000000000111111111111111111111111111110
1111111111111111111111111111110000000000000000000000000000000000000000111111111111111111111111111110
1111111111111111111111111111111111110000000000000000000000000000111111111111111111111111111111111110
1111111111111111111111111111111111110000000000000000000000000000111111111111111111111111111111111110
1111111111111111111111111111111111111111110000000000000000111111111111111111111111111111111111111110
1111111111111111111111111111111111111111110000000000000000111111111111111111111111111111111111111110
1111111111111111111111111111111111111111111100000000000011111111111111111111111111111111111111111110
1111111111111111111111111111111111111111111100000000000011111111111111111111111111111111111111111110
1111111111111111111111111111111111111111111111000000001111111111111111111111111111111111111111111110
1111111111111111111111111111111111111111111111000000001111111111111111111111111111111111111111111110
1111111111111111111111111111111111111111111111000000001111111111111111111111111111111111111111111110
1111111111111111111111111111111111111111111111000000001111111111111111111111111111111111111111111110
1111111111111111111111111111111111111111111111000000001111111111111111111111111111111111111111111110
1111111111111111111111111111111111111111111111000000001111111111111111111111111111111111111111111110
1111111111111111111111111111111111111111111111000000001111111111111111111111111111111111111111111110
1111111111111111111111111111111111111111111111000000001111111111111111111111111111111111111111111110
1111111111111111111111111111111111111111111111000000001111111111111111111111111111111111111111111110
1111111111111111111111111111111111111111111111000000001111111111111111111111111111111111111111111110
1111111111111111111111111111111111111111111111000000001111111111111111111111111111111111111111111110
1111111111111111111111111111111111111111111111000000001111111111111111111111111111111111111111111110
1111111111111111111111111111111111111111111111111111111111111111111111111111111111111111111111111110
1111111111111111111111111111111111111111111111111111111111111111111111111111111111111111111111111110
1111111111111111111111111111111111111111111111111111111111111111111111111111111111111111111111111110
1111111111111111111111111111111111111111111111111111111111111111111111111111111111111111111111111110
