0000000000000000000000000000000000000000000000000000000000000000000000000000000000000000000000000000
1111111111111111111111111111111111111111111111111111111111111111111111111111111111111111111111111110
1111111111111111111111111111111111111111111111111111111111111111111111111111111111111111111111111110
1111111111111111111111111111111111111111111111111111111111111111111111111111111111111111111111111110
1111111111111111111111111111111111111111111111111111111111111111111111111111111111111111111111111110
1111111111111111111111111111111111111111111111111111111111111111111111111111111111111111111111111110
1111111111111111111111111111111111111111111111111111111111111111111111111111111111111111111111111110
1111111111111111111111111111111111111111111111111111111111111111111111111111111111111111111111111110
1111111111111111111111111111111111111111111111111111111111111111111111111111111111111111111111111110
1111111111111111111111111111111111111111111111111111111111111111111111111111111111111111111111111110
1111111111111111111111111111111111111111111111111111111111111111111111111111111111111111111111111110
1111111111111111111111111111111111111111111111111111111111111111111111111111111111111111111111111110
1111111111111111110000000000000111111111111111111111111111111111111111111111111111111111111111111110
1111111111111111110000000000000111111111111111111111111111111111111111111111111111111111111111111110
1111111111111111110000000000000111111111111111111111111111111111111111111111111111111111111111111110
1111111111111111110000111111111111111111111111111111111111111111111111111111111111111111111111111110
1111111111111111110000001111111111111111111111111111111111111111111111111111111111111111111111111110
1111111111111111110000001111111111111111111111111111111111111111111111111111111111111111111111111110
1111111111111111110001000111111111111111111111111111111111111111111111111111111111111111111111111110
1111111111111111110000000011111111111111111111111111111111111111111111111111111111111111111111111110
1111111111111111110000000011111111111111111111111111111111111111111111111111111111111111111111111110
1111111111111111110011100000011111111111111111111111111111111111111111111111111111111111111111111110
1111111111111111111011101000001111111111111111111111111111111111111111111111111111111111111111111110
1111111111111111110011100000000011111111111111111111111111111111111111111111111111111111111111111110
1111111111111111110000000000000011111111111111111111111111111111111111111111111111111111111111111110
1111111111111111110000000000000011111111111111111111111111111111111111111111111111111111111111111110
1111111111111111111111111111111111111111111111111111111111111111111111111111111111111111111111111110
1111111111111111111111111111111111111111111111111111111111111111111111111111111111111111111111111110
1111111111111111111111111111111111111111111111111111111111111111111111111111111111111111111111111110
1111111111111111111111111111111111111111111111111111111111111111111111111111111111111111111111111110
1111111111111111111111111111111111111111111111111111111111111111111111111111111111111111111111111110
1111111111111111111111111111111111111111111111111111111111111111111111111111111111111111111111111110
1111111111111111111111111111111111111111111111111111111111111111111111111111111111111111111111111110
1111111111111111111111111111111111111111111111111111111111111111111111111111111111111111111111111110
1111111111111111111111111111111111111111111111111111111111111111111111110000000000111111111111111110
1111111111111111111111111111111111111111111111111111111111111111111111110000000000111111111111111110
1111111111111111111111111111111111111111111111111111111111111111111111110000000011111111111111111110
1111111111111111111111111111111111111111111111111111111111111111111111110000000011111111111111111110
1111111111111111111111111111111111111111111111111111111111111111111110000000000011111111111111111110
1111111111111111111111111111111111111111111111111111111111111111111110000000000011111111111111111110
1111111111111111111111111111111111111111111111111111111111111111100000000000000000111111111111111110
1111111111111111111111111111111111111111111111111111111111111111100000000000000000111111111111111110
1111111111111111111111111111111111111111111111111111111111111111100000000000000000111111111111111110
1111111111111111111111111111111111111111111111111111111111111111100000000000000000111111111111111110
1111111111111111111111111111111111111111111111111111111111111111100000000000000000000000111111111110
1111111111111111111111111111111111111111111111111111111111111111100000000000000000000000111111111110
1111111111111111111111111111111111111111111111111111111111111111100000000000000000000000001111111110
1111111111111111111111111111111111111111111111111111111111111111100000000000000000000000001111111110
1111111111111111111111111111111111111111111111111111111111111111100000000000000000000000001111111110
1111111111111111111111111111111111111111111111111111111111111111100000000000000000000000001111111110
1111111111111111111111111111111111111111111111111111111111111111100000000000000000000000001111111110
1111111111111111111111111111111111111111111111111111111111111111100000000000000000000000001111111110
1111111111111111111111111111111111111111111111111111111111111111100000000000000000000000001111111110
1111111111111111111111111111111111111111111111111111111111111111100000000000000000000000001111111110
1111111111111111111111111111111111111111111111111111111111111111100000000000000000000000111111111110
1111111111111111111111111111111111111111111111111111111111111111100000000000000000000000111111111110
1111111111111111111111111111111111111111111111111111111111111111100000000000000000111111111111111110
1111111111111111111111111111111111111111111111111111111111111111100000000000000000111111111111111110
1111111111111111111111111111111111111111111111111111111111111111100000000000000000111111111111111110
1111111111111111111111111111111111111111111111111111111111111111100000000000000000111111111111111110
1111111111111111111111111111111111111111111111111111111111111111111110000000000011111111111111111110
1111111111111111111111111111111111111111111111111111111111111111111110000000000011111111111111111110
1111111111111111111111111111111111111111111111111111111111111111111111110000000011111111111111111110
1111111111111111111111111111111111111111111111111111111111111111111111110000000011111111111111111110
1111111111111111111111111111111111111111111111111111111111111111111111110000000000111111111111111110
1111111111111111111111111111111111111111111111111111111111111111111111110000000000111111111111111110
1111111111111111111111111111111111111111111111111111111111111111111111111111111111111111111111111110
1111111111111111111111111111111111111111111111111111111111111111111111111111111111111111111111111110
1111111111111111000000000000111111111111111111111111111111111111111111111111111111111111111111111110
1111111111111111000001100000111111111111111111111111111111111111111111111111111111111111111111111110
1111111111110000000001100000000011111111111111111111111111111111111111111111111111111111111111111110
1111111111110000000111111000000011111111111111111111111111111111111111111111111111111111111111111110
1111111111110000000111111000000011111111111111111111111111111111111111111111111111111111111111111110
1111111111110000000001111000000011111111111111111111111111111111111111111111111111111111111111111110
1111111111110000000000000000000011111111111111111111111111111111111111111111111111111111111111111110
1111111111110000000000000000000011111111111111111111111111111111111111111111111111111111111111111110
1111111111110000000011100000000011111111111111111111111111111111111111111111111111111111111111111110
1111111111110000000010100000000011111111111111111111111111111111111111111111111111111111111111111110
1111111111110000000000000000000011111111111111111111111111111111111111111111111111111111111111111110
1111111111110000011011101100000011111111111111111111111111111111111111111111111111111111111111111110
1111111111110000010011100100000011111111111111111111111111111111111111111111111111111111111111111110
1111111111110000010011100100000011111111111111111111111111111111111111111111111111111111111111111110
1111111111110000011011101100000011111111111111111111111111111111111111111111111111111111111111111110
1111111111110000000011100000000011111111111111111111111111111111111111111111111111111111111111111110
1111111111110000000000000000000011111111111111111111111111111111111111111111111111111111111111111110
1111111111110000000000000000000011111111111111111111111111111111111111111111111111111111111111111110
1111111111000000000000000000000000111111111111111111111111111111111111111111111111111111111111111110
1111111111000000000000000000000000111111111111111111111111111111111111111111111111111111111111111110
1111111111111111110000000011111111111111111111111111111111111111111111111111111111111111111111111110
1111111111111111110000000011111111111111111111111111111111111111111111111111111111111111111111111110
1111111111111111111111111111111111111111111111111111111111111111111111111111111111111111111111111110
1111111111111111111111111111111111111111111111111111111111111111111111111111111111111111111111111110
1111111111111111111111111111111111111111111111111111111111111111111111111111111111111111111111111110
1111111111111111111111111111111111111111111111111111111111111111111111111111111111111111111111111110
1111111111111111111111111111111111111111111111111111111111111111111111111111111111111111111111111110
1111111111111111111111111111111111111111111111111111111111111111111111111111111111111111111111111110
1111111111111111111111111111111111111111111111111111111111111111111111111111111111111111111111111110
1111111111111111111111111111111111111111111111111111111111111111111111111111111111111111111111111110
1111111111111111111111111111111111111111111111111111111111111111111111111111111111111111111111111110
1111111111111111111111111111111111111111111111111111111111111111111111111111111111111111111111111110
