000000000000000000000000000000000000000000000000000000000000000000000000000000000000000000000000000000000000000000000000
111111111111111111111111111111111111111111111111111111111111111111111111111111111111111111111111111111111111111111111110
111111111111111111111111111111111111111111111111111111111111111111111111111111111111111111111111111111111111111111111110
111111111111111111111111111111111111111111111111111111111111111111111111111111111111111111111111111111111111111111111110
111111111111111111111111111111111111111111111111111111111111111111111111111111111111111111111111111111111111111111111110
111111111111111111111111111111111111111111111111111111111111111111111111111111111111111111111111111111111111111111111110
111111111111111111111111111111111111111111111111111111111111111111111111111111111111111111111111111111111111111111111110
111111111111111111111111111111111111111111111111111111111111111111111111111111111111111111111111111111111111111111111110
111111111111111111111111111111111111111111111111111111111111111111111111111111111111111111111111111111111111111111111110
111111111111111111111111111111111111111111111111111111111111111111111111111111111111111111111111111111111111111111111110
111111111111111111111111111111111111111111111111111111111111111111111111110000000001101100001101100000000011111111111110
111111111111111111111111111111111111111111111111111111111111111111111111110000000000000000000000000000000011111111111110
111111111111111111111111111111111111111111111111111111111111111111111111000000000000000000000000000000000000001111111110
111111111111111111111111111111111111111111111111111111111111111111111111000000000000000001100000000000000000001111111110
111111111111111111111111111111111111111111111111111111111111111111111111000000000000000000000000000000000000001111111110
111111111111111111111111111111111111111111111111111111111111111111111111000000000000000110011000000000000000001111111110
111111111111111111111111111111111111111111111111111111111111111111111111000000000000000111111000000000000000001111111110
111111111111111111111111111111111111111111111111111111111111111111111111000000011000000111111000000110000000001111111110
111111111111111111111111111111111111111111111111111111111111111111111111001100011000000000000000000110001100001111111110
111111111111111111111111111111111111111111111111111111111111111111111111001100000000000000000000000000001100001111111110
111111111111111111111111111111111111111111111111111111111111111111111111001100000000000011110000000000001100001111111110
111111111111111111111111111111111111111111111111111111111111111111111111001100000000000010010000000000001100001111111110
111111111111111111111111111111111111111111111111111111111111111111111111000000000000000000000000000000000000001111111110
111111111111111111111111111111111111111111111111111111111111111111111111000000000000011011110110000000000000001111111110
111111111111111111111111111111111111111111111111111111111111111111111111000000000000010011110010000000000000011111111110
111111111111111111111111111111111111111111111111111111111111111111111111000000011000010011110010000110000000011111111110
111111111111111111111111111111111111111111111111111111111111111111111111000000011000011011110110000110000000001111111110
111111111111111111111111111111111111111111111111111111111111111111111111000000000000011011110110000000000000001111111110
111111111111111111111111111111111111111111111111111111111111111111111111001100000000010011110010000000001100001111111110
111111111111111111111111111111111111111111111111111111111111111111111111001100000000010011110010000000001100001111111110
111111111111111111111111111111111111111111111111111111111111111111111111001100000000011000000110000000001100001111111110
111111111111111111111111111111111111111111111111111111111111111111111111001100000000000000000000000000001100001111111110
111111111111111111111111111111111111111111111111111111111111111111111111000000000000000000000000000000000000001111111110
111111111111111111111111111111111111111111111111111111111111111111111111000000011000000000000000000110000000001111111110
111111111111111111111111111111111111111111111111111111111111111111111111000000011000000000000000000110000000001111111110
111111111111111111111111111111111111111111111111111111111111111111111111000000000000000000000000000000000000001111111110
111111111111111111111111111111111111111111111111111111111111111111111111000000000000000000000000000000000000001111111110
111111111111111111111111111111111111111111111111111111111111111111111111000000000000000000000000000000000000001111111110
111111111111111111111111111111111111111111111111111111111111111111111111111111111111111111110000001111111111111111111110
111111111111111111111111111111111111111111111111111111111111111111111111111111111111111111110000001111111111111111111110
111111111111111111111111111111111111111111111111111111111111111111111111111111111111111111110000001111111111111111111110
111111111111111111111111111111111111111111111111111111111111111111111111111111111111111111110000001111111111111111111110
111111111111111111111111111111111111111111111111111111111111111111111111111111111111111111111111111111111111111111111110
111111111111111111111111111111111111111111111111111111111111111111111111111111111111111111111111111111111111111111111110
111111111111111111111111111111111111111111111111111111111111111111111111111111111111111111110000001111111111111111111110
111111111111111111111111111111111111111111111111111111111111111111111111111111111111111111110000001111111111111111111110
111111111111111111111111111111111111111111111111111111111111111111111111000000000000000000000000000000000000001111111110
111111111111111111111111111111111111111111111111111111111111111111111111000000000000000000000000000000000000001111111110
111111111111111111111111111111111111111111111111111111111111111111111111000000000000000000000000000000000000111111111110
111111111111111111111111111111111111111111111111111111111111111111111111000000000000000000000000000000000000111111111110
111111111111111111111111111111111111111111111111111111111111111111111100000000000000000000000000000000000000001111111110
111111111111111111111111111111111111111111111111111111111111111111111100000000000000000000000000000000000000001111111110
111111111111111111111111111111111111111111111111111111111111111111111100000000000000000000000000000000000000001111111110
111111111111111111111111111111111111111111111111111111111111111111111100000000000000000000000000000000000000001111111110
111111111111111111111111111111111111111111111111111111111111111111111100000000000000000000000000000000000000001111111110
111111111111111111111111111111111111111111111111111111111111111111111100000000000000000000000000000000000000001111111110
111111111111111111111111111111111111111111111111111111111111111111111111000000000000000000000000000000000000111111111110
111111111111111111111111111111111111111111111111111111111111111111111111000000000000000000000000000000000000111111111110
111111111111111111111111111111111111111111111111111111111111111111111111000000000000000000000000000000000000001111111110
111111111111111111111111111111111111111111111111111111111111111111111111000000000000000000000000000000000000001111111110
111111111111111111111111111111111111111111111111111111111111111111111111111111111111111111111111111111111111111111111110
111111111111111111111111111111111111111111111111111111111111111111111111111111111111111111111111111111111111111111111110
111111111111111111111111111111111111111111111111111111111111111111111111111111111111111111111111111111111111111111111110
111111111111111111111111111111111111111111111111111111111111111111111111111111111111111111111111111111111111111111111110
111111111111111111111111111111111111111111111111111111111111111111111111111111111111111111111111111111111111111111111110
111111111111111111111111111111111111111111111111111111111111111111111111111111111111111111111111111111111111111111111110
111111111111111111111111111111111111111111111111111111111111111111111111111111111111111111111111111111111111111111111110
111111111111111111111111111111111111111111111111111111111111111111111111111111111111111111111111111111111111111111111110
111111111111111111111111111111111111111111111111111111111111111111111111111111111111111111111111111111111111111111111110
111111111111111111111111111111111111111111111111111111111111111111111111111111111111111111111111111111111111111111111110
111111111111111111111111111111111111111111111111111111111111111111111111111111111111111111111111111111111111111111111110
111111111111111111111111111111111111111111111111111111111111111111111111111111111111111111111111111111111111111111111110
111111111111111111111111111111111111111111111111111111111111111111111111111111111111111111111111111111111111111111111110
111111111111111111111111111111111111111111111111111111111111111111111111111111111111111111111111111111111111111111111110
111111111111111111111111111111111111111111111111111111111111111111111111111111111111111111111111111111111111111111111110
111111111111111111111111111111111111111111111111111111111111111111111111111111111111111111111111111111111111111111111110
111111111111111111111111111111111111111111111111111111111111111111111111111111111111111111111111111111111111111111111110
111111111111111111111111111111111111111111111111111111111111111111111111111111111111111111111111111111111111111111111110
111111111111111111111111111111111111111111111111111111111111111111111111111111111111111111111111111111111111111111111110
111111111111111111111111111111111111111111111111111111111111111111111111111111111111111111111111111111111111111111111110
111111111111111111111111111111111111111111111111111111111111111111111111111111111111111111111111111111111111111111111110
111111111111111111111111111111111111111111111111111111111111111111111111111111111111111111111111111111111111111111111110
111111111111111111111111111111111111111111111111111111111111111111111111111111111111111111111111111111111111111111111110
111111111111111111111111111111111111111111111111111111111111111111111111111111111111111111111111111111111111111111111110
111111111111111111111111111111111111111111111111111111111111111111111111111111111111111111111111111111111111111111111110
111111111111111111111111111111111111111111111111111111111111111111111111111111111111111111111111111111111111111111111110
111111111111111111111111111111111111111111111111111111111111111111111111111111111111111111111111111111111111111111111110
111111111111111111111111111111111111111111111111111111111111111111111111111111111111111111111111111111111111111111111110
111111111111111111111111111111111111111111111111111111111111111111111111111111111111111111111111111111111111111111111110
111111111111111111111111111111111111111111111111111111111111111111111111111111111111111111111111111111111111111111111110
111111111111111111111111111111111111111111111111111111111111111111111111111111111111111111111111111111111111111111111110
111111111111111111111111111111111111111111111111111111111111111111111111111111111111111111111111111111111111111111111110
111111111111111111111111111111111111111111111111111111111111111111111111111111111111111111111111111111111111111111111110
111111111111111111111111111111111111111111111111111111111111111111111111111111111111111111111111111111111111111111111110
111111111111111111111111111111111111111111111111111111111111111111111111111111111111111111111111111111111111111111111110
111111111111111111111111111111111111111111111111111111111111111111111111111111111111111111111111111111111111111111111110
111111111111111111111111111111111111111111111111111111111111111111111111111111111111111111111111111111111111111111111110
111111111111111111111111111111111111111111111111111111111111111111111111111111111111111111111111111111111111111111111110
111111111111111111111111111111111111111111111111111111111111111111111111111111111111111111111111111111111111111111111110
111111111111111111111111111111111111111111111111111111111111111111111111111111111111111111111111111111111111111111111110
111111111111111111111111111111111111111111111111111111111111111111111111111111111111111111111111111111111111111111111110
111111111111111111111111111111111111111111111111111111111111111111111111111111111111111111111111111111111111111111111110
111111111111111111111111111111111111111111111111111111111111111111111111111111111111111111111111111111111111111111111110
111111111111111111111111111111111111111111111111111111111111111111111111111111111111111111111111111111111111111111111110
111111111111111111111111111111111111111111111111111111111111111111111111111111111111111111111111111111111111111111111110
111111111111111111111111111111111111111111111111111111111111111111111111111111111111111111111111111111111111111111111110
111111111111111111111111111111111111111111111111111111111111111111111111111111111111111111110000000000000011111111111110
111111111111111111111111111111111111111111111111111111111111111111111111111111111111111111110000000000000011111111111110
111111111111111111111111111111111111111111111111111111111111111111111111111111111111111111110000000000000011111111111110
111111111111111111111111111111111111111111111111111111111111111111111111111111111111111111110000000000000011111111111110
111111111111111111111111111111111111111111111111111111111111111111111111111111111111111111110000000000000011111111111110
111111111111111111111111111111111111111111111111111111111111111111111111111111111111111111110000000000000011111111111110
111111111111111111111111111111111111111111111111111111111111111111111111111111111111111111110000000000000011111111111110
111111111111111111111111111111111111111111111111111111111111111111111111111111111111111111110000000000000011111111111110
111111111111111111111111111111111111111111111111111111111111111111111111111111111111111111110000000000000011111111111110
111111111111111111111111111111111111111111111111111111111111111111111111111111111111111111110000000000000011111111111110
111111111111111111111111111111111111111111111111111111111111111111111111111111111111111111110000000000000011111111111110
111111111111111111111111111111111111111111111111111111111111111111111111111111111111111111110000000000000011111111111110
111111111111111111111111111111111111111111111111111111111111111111111111111111111111111111110000000000000011111111111110
111111111111111111111111111111111111111111111111111111111111111111111111111111111111111111110000000000000011111111111110
111111111111111111111111111111111111111111111111111111111111111111111111111111111111111111110000000000000011111111111110
111111111111111111111111111111111111111111111111111111111111111111111111111111111111111111110000000000000011111111111110
111111111111111111111111111111111111111111111111111111111111111111111111111111111111111111111100000000111111111111111110
111111111111111111111111111111111111111111111111111111111111111111111111111111111111111111111100000000111111111111111110
111111111111111111111111111111111111111111111111111111111111111111111111111111111111111111111111111111111111111111111110
111111111111111111111111111111111111111111111111111111111111111111111111111111111111111111111111111111111111111111111110
111111111111111111111111111111111111111111111111111111111111111111111111111111111111111111111111111111111111111111111110
111111111111111111111111111111111111111111111111111111111111111111111111111111111111111111111111111111111111111111111110
111111111111111111111111111111111111111111111111111111111111111111111111111111111111111111111111111111111111111111111110
111111111111111111111111111111111111111111111111111111111111111111111111111111111111111111111111111111111111111111111110
111111111111111111111111111111111111111111111111111111111111111111111111111111111111111111111111111111111111111111111110
111111111111111111111111111111111111111111111111111111111111111111111111111111111111111111111111111111111111111111111110
111111111111111111111111111111111111111111111111111111111111111111111111111111111111111111111111111111111111111111111110
111111111111111111111111111111111111111111111111111111111111111111111111111111111111111111111111111111111111111111111110
111111111111111111111111111111111111111111111111111111111111111111111111111111111111111111111111111111111111111111111110
111111111111111111111111111111111111111111111111111111111111111111111111111111111111111111111111111111111111111111111110
111111111111000000000000000000000000000000001111111111111111111111111111111111111111111111111111111111111111111111111110
111111111111000000000000000000000000000000001111111111111111111111111111111111111111111111111111111111111111111111111110
111111111111000000000000000000000000000000000011111111111111111111111111111111111111111111111111111111111111111111111110
111111111111000000000000000000000000000000000011111111111111111111111111111111111111111111111111111111111111111111111110
111111111111000000000000000000000000000000000011111111111111111111111111111111111111111111111111111111111111111111111110
111111111111000000000000000000000000000000000011111111111111111111111111111111111111111111111111111111111111111111111110
111111111111000000000000000000000000000000000000111111111111111111111111111111111111111111111111111111111111111111111110
111111111111000000000000000000000000000000000000111111111111111111111111111111111111111111111111111111111111111111111110
111111111111000000000000000000000000000000000000111111111111111111111111111111111111111111111111111111111111111111111110
111111111111000000000000000000000000000000000000111111111111111111111111111111111111111111111111111111111111111111111110
111111111111000000000000000000000000000000000000111111111111111111111111111111111111111111111100000000111111111111111110
111111111111000000000000000000000000000000000000111111111111111111111111111111111111111111111100000000111111111111111110
111111111100000000000000000000000000000000000000111111111111111111111111111111111111111111111100000000111111111111111110
111111111100000000000000000000000000000000000000111111111111111111111111111111111111111111111100000000111111111111111110
111111111100000000000000000000000000000000000000111111111111111111111111111111111111111111111110000000010011111111111110
111111111100000000000000000000000000000000000000111111111111111111111111111111111111111101111110000000000011111111111110
111111111100000000000000000000000000000000000000111111111111111111111111111111111111111100000000000000000011111111111110
111111111100000000000000000000000000000000000000111111111111111111111111111111111111111100000000000000000011111111111110
111111111100000000000000000000000000000000000000111111111111111111111111111111111111111100000000000000000011111111111110
111111111100000000000000000000000000000000000000111111111111111111111111111111111111111100000000000000000011111111111110
111111111111000000000000000000000000000000000000111111111111111111111111111111111111111100110000000000000011111111111110
111111111111000000000000000000000000000000000000111111111111111111111111111111111111111100111000000000000111111111111110
111111111111000000000000000000000000000000000000111111111111111111111111111111111111111100000000111111000011111111111110
111111111111000000000000000000000000000000000000111111111111111111111111111111111111111100000000111111000011111111111110
111111111111000000000000000000000000000000000000111111111111111111111111111111111111111100000001111111100011111111111110
111111111111000000000000000000000000000000000000111111111111111111111111111111111111111100000001111111100011111111111110
111111111111000000000000000000000000000000000000111111111111111111111111111111111111111100000000111111000011111111111110
111111111111000000000000000000000000000000000000111111111111111111111111111111111111111111100000111111000011111111111110
111111111111000000000000000000000000000000000000111111111111111111111111111111111111111111100000000000000011111111111110
111111111111000000000000000000000000000000000000111111111111111111111111111111111111111111100100000000000011111111111110
111111111111000000000000000000000000000000000000111111111111111111111111111111111111111111100000000000000011111111111110
111111111111000000000000000000000000000000000000111111111111111111111111111111111111111111100000000000000011111111111110
111111111111111111111111111111111111111111111111111111111111111111111111111111111111111100000000000000000011111111111110
111111111111111111111111111111111111111111111111111111111111111111111111111111111111111100000000000000000111111111111110
111111111111111111111111111111111111111111111111111111111111111111111111111111111111111111111111111111111111111111111110
111111111111111111111111111111111111111111111111111111111111111111111111111111111111111111111111111111111111111111111110
111111111111111111111111111111111111111111111111111111111111111111111111111111111111111111111111111111111111111111111110
111111111111111111111111111111111111111111111111111111111111111111111111111111111111111111111111111111111111111111111110
111111111111111111111111111111111111111111111111111111111111111111111111111111111111111111111111111111111111111111111110
111111111111111111111111111111111111111111111111111111111111111111111111111111111111111111111111111111111111111111111110
111111111111111111111111111111111111111111111111111111111111111111111111111111111111111111111111111111111111111111111110
111111111111111111111111111111111111111111111111111111111111111111111111111111111111111111111111111111111111111111111110
111111111111111111111111111111111111111111111111111111111111111111111111111111111111111111111111111111111111111111111110
111111111111111111111111111111111111111111111111111111111111111111111111111111111111111111111111111111111111111111111110
