0000000000000000000000000000000000000000000000000000000000000000000000000000000000000000000000000000
1111111111111111111111111111111111111111111111111111111111111111111111111111111111111111111111111110
1111111111111111111111111111111111111111111111111111111111111111111111111111111111111111111111111110
1111111111111111111111111111111111111111111111111111111111111111111111111111111111111111111111111110
1111111111111111111111111111111111111111111111111111111111111111111111111111111111111111111111111110
1111111111111111111111111111111111111111111111111111111111111111111111111111111111111111111111111110
1111111111111111111111111111111111111111111111111111111111111111111111111111111111111111111111111110
1111111111111111111111111111111111111111111111111111111111111111111111111111111111111111111111111110
1111111111111111111111111111111111111111111111111111111111111111111111111111111111111111111111111110
1111111111111111111111111111111111111111111111111111111111111111111111111111111111111111111111111110
1111111111111111111111111111111111111111111111111111111111111111111111111111111111111111111111111110
1111111111111111111111111111111111111111111111111111111111111111111111111111111111111111111111111110
1111111111111111111111111111111111111111111111111111111111111111111111111111111111111111111111111110
1111111111111111111111111111111111111111111111111111111111111111111111111111111111111111111111111110
1111111111111111111111111111111111111111111111111111111111111111111111111111111111111111111111111110
1111111111111111111111111111111111111111111111111111111111111111111111111111111111111111111111111110
1111111111111111111111111111111111111111111111111111111111111111111111111111111111111111111111111110
1111111111111111111111111111111111111111111111111111111111111111111111111111111111111111111111111110
1111111111111111111111111111111111111111111111111111111111111111111111111111111111111111111111111110
1111111111111111111111111111111111111111111111111111111111111111111111111111111111111111111111111110
1111111111111111111111111111111111111111111111111111111111111111111111111111111111111111111111111110
1111111111111111111111111111111111111111111111111111111111111111111111111111111111111111111111111110
1111111111111111111111111111111111111111111111111111111111111111111111111111111111111111111111111110
1111111111111111111111111111111111111111111111111111111111111111111111111111111111111111111111111110
1111111111111111111111111111111111111111111111111111111111111111111111111111111111111111111111111110
1111111111111111111111111111111111111111111111111111111111111111111111111111111111111111111111111110
1111111111111111111111111111111111111111111111111111111111111111111111111111111111111111111111111110
1111111111111111111111111111111111111111111111111111111111111111111111111111111111111111111111111110
1111111111111111111111111111111111111111111111111111111111111111111111111111111111111111111111111110
1111111111111111111111111111111111111111111111111111111111111111111111111111111111111111111111111110
1111111111111111111111111111111111111111111111111111111111111111111111111111111111111111111111111110
1111111111111111111111111111111111111111111111111111111111111111111111111111111111111111111111111110
1111111111111111111111111111111111111111111111111111111111111111111111111100011111111111111111111110
1111111111111111111111111111111111111111111111111111111111111111111111111100011111111111111111111110
1111111111111111111111111111111111111111111111111111111111110000000000000000001111111111111111111110
1111111111111111111111111111111111111111111111111111111111110000000000000000000111111111111111111110
1111111111111111111111111111111111111111111111111111111111100000000000000000000111111111111111111110
1111111111111111111111111100000000000000000000000000000000000000000000000000000111111111111111111110
1111111111111111111111111100000000000000000000000000000000000000000111100000000111111111111111111110
1111111111111111111111111100111111111111111111111111111111111000001111110000000111111111111111111110
1111111111111111111111111100111111111111111111111111111111111000001110000000000111111111111111111110
1111111111111111111111111100110000000000000000000000000000011000001110000000000111111111111111111110
1111111111111111111111111100111111111111111111111111111111111000001110000000001111111111111111111110
1111111111111111111111111100110000000000000000000000000000011000001110000000001111111111111111111110
1111111111111111111111111100111111111111111111111111111111111000001110000000000111111111111111111110
1111111111111111111111111100110000000000000000000000000000011000001110000000011111111111111111111110
1111111111111111111111111100111111111111111111111111111111111000001110000000011111111111111111111110
1111111111111111111111111100110000000000000000000000000000011000001110000000011111111111111111111110
1111111111111111111111111100111111111111111111111111111111111000001110000000011111111111111111111110
1111111111111111111111111100110000000000000000000000000000011000001110000000011111111111111111111110
1111111111111111111111111100111111111111111111111111111111111000001110000000011111111111111111111110
1111111111111111111111111100110000000000000000000000000000011000001110000000011111111111111111111110
1111111111111111111111111100111111111111111111111111111111111000001110000000011111111111111111111110
1111111111111111111111111100111111111111111111111111111111111000001110000000011111111111111111111110
1111111111111111111111111100000000000000000000000000000000000000001110000001011111111111111111111110
1111111111111111111111111100000000000000000000000000000000000000001110111111111111111111111111111110
1111111111111111111111111100000000000000000000000000000000000000001110111111111111111111111111111110
1111111111111111111111111111111111111111111111111111111111111111111110110001111111111111111111111110
1111111111111111111111111111111111111111111111111111111111111111111110000000011111111111111111111110
1111111111111111111111111111111111111111111111111111111111111111111110000000011111111111111111111110
1111111111111111111111111111111111111111111111111111111111111111111110000000011111111111111111111110
1111111111111111111111111111111111111111111111111111111111111111111110000000011111111111111111111110
1111111111111111111111111111111111111111111111111111111111111111111111111111111111111111111111111110
1111111111111111111111111111111111111111111111111111111111111111111111111111111111111111111111111110
1111111111111111111111111111111111111111111111111111111111111111111111111111111111111111111111111110
1111111111111111111111111111111111111111111111111111111111111111111111111111111111111111111111111110
1111111111111111111111111111111111111111111111111111111111111111111111111111111111111111111111111110
1111111111111111111111111111111111111111111111111111111111111111111111111111111111111111111111111110
1111111111111111111111111111111111111111111111111111111111111111111111111111111111111111111111111110
1111111111111111111111111111111111111111111111111111111111111111111111111111111111111111111111111110
1111111111111111111111111111111111111111111111111111111111111111111111111111111111111111111111111110
1111111111111111111111111111111111111111111111111111111111111111111111111111111111111111111111111110
1111111111111111111111111111111111111111111111111111111111111111111111111111111111111111111111111110
1111111111111111111111111111111111111111111111111111111111111111111111111111111111111111111111111110
1111111111111111111111111111111111111111111111111111111111111111111111111111111111111111111111111110
1111111111111111111111111111111111111111111111111111111111111111111111111111111111111111111111111110
1111111111111111111111111111111111111111111111111111111111111111111111111111111111111111111111111110
1111111111111111111111111111111111111111111111111111111111111111111111111111111111111111111111111110
1111111111111111111111111111111111111111111111111111111111111111111111111111111111111111111111111110
1111111111111111111111111111111111111111111111111111111111111111111111111111111111111111111111111110
