0000000000000000000000000000000000000000000000000000000000000000000000000000000000000000000000000000
1111111111111111111111111111111111111111111111111111111111111111111111111111111111111111111111111110
1111111111111111111111111111111111111111111111111111111111111111111111111111111111111111111111111110
1111111111111111111111111111111111111111111111111111111111111111111111111111111111111111111111111110
1111111111111111111111111111111111111111111111111111111111111111111111111111111111111111111111111110
1111111111111111111111111111111111111111111111111111111111111111111111111111111111111111111111111110
1111111111111111111111111111111111111111111111111111111111111111111111111111111111111111111111111110
1111111111111111111111111111111111111111111111111111111111111111111111111111111111111111111111111110
1111111111111111111111111111111111111111111111111111111111111111111111111111111111111111111111111110
1111111111111111111111111111111111111111111111111111111111111111111111111111111111111111111111111110
1111111111111111111111111111111111111111111111111111111111111111111111111111111111111111111111111110
1111111111111111111111111111111111111111111111111111111111111111111111111111111111111111111111111110
1111111111111111111111111111111111111111111111111111111111111111111111111111111111111111111111111110
1111111111111111111111111111111111111111111111111111111111111111111111111111111111111111111111111110
1111111111111111111111111111111111111111111111111111111111111111111111111111111111111111111111111110
1111111111111111111111111111111111111111111111111111111111111111111111111111111111111111111111111110
1111111111111111111111111111111111111111111111111111111111111111111111111111111111111111111111111110
1111111111111111111111111111111111111111111111111111111111111111111111111111111111111111111111111110
1111111111111111111111111111111111111111111111111111111111111111111111111111111111111111111111111110
1111111111111111111111111111111111111111111111111111111111111111111111111111111111111111111111111110
1111111111111111000001100000111111111111111111111111111111111110010111111111111111111111111111111110
1111111111111111100001110011111111111111111111111111111111111110010111111111111111111111111111111110
1111111111111101000001100011001111111111111111111111111110000000000000111111111111111111111111111110
1111111111111100000000111000001111111111111111111111111100000000000000001111111111111111111111111110
1111111111111111110000111000001111111111111111111111111100000000000000001111111111111111111111111110
1111111111111111100000000000101111111111111111111111111100000000000000001111111111111111111111111110
1111111111111101000000000000111111111111111111111111111100000001100000001111111111111111111111111110
1111111111111100000000000000111111111111111111111111111100000001100000001111111111111111111111111110
1111111111111100000000000000111111111111111111111111111100000100001000001111111111111111111111111110
1111111111111100000000000000001111111111111111111111111100000111111000111111111111111111111111111110
1111111111111101000000000000000000001111111111111111000000000111111000000000111111111111111111111110
1111111111111111100000000000000000001111111111111111000000000000000000000000111111111111111111111110
1111111111111101000000000000000000001111111111111111000000000000000000000000111111111111111111111110
1111111111111100000000000000000000001111111111111111000000000000000000000000111111111111111111111110
1111111111111111111111000000111111111111111111111111111100000000000000001111111111111111111111111110
1111111111111111111111000000111111111111111111111111111111000000000000111111111111111111111111111110
1111111111111111111111000000011111111111111111111111111111000000000000111111111111111111111111111110
1111111111111111100111000000011111111111111111111111111100000000000000111111111111111111111111111110
1111111111111111100111000000001111111111111111111111111100000000000000011111111111111111111111111110
1111111111111111100111000000001111111111111111111111111111000000000000111111111111111111111111111110
1111111111111100000000000000011111111111111111111111111111000000000000111111111111111111111111111110
1111111111111100000000000011111111111111111111111111111100001000001100001111111111111111111111111110
1111111111111100000000000011111111111111111111111111111111111100001111111111111111111111111111111110
1111111111111100000000000011111111111111111111111111111111111100001111111111111111111111111111111110
1111111111111111111111111111111111111111111111111111111111111111111111111111111111111111111111111110
1111111111111111111111111111111111111111111111111111111111111111111111111111111111111111111111111110
1111111111111111111111111111111111111111111111111111111111111111111111111111111111111111111111111110
1111111111111111111111111111111111111111111111111111111111111111111111111111111111111111111111111110
1111111111111111111111111111111111111111111111111111111111111111111111111111111111111111111111111110
1111111111111111111111111111111111111111111111111111111111111111111111111111111111111111111111111110
1111111111111111111111111111111111111111111111111111111111111111111111111111111111111111111111111110
1111111111111111111111111111111111111111111111111111111111111111111111111111111111111111111111111110
1111111111111111111111111111111111111111111111111111111111111111111111111111111111111111111111111110
1111111111111111111111111111111111111111111111111111111111111111111111111111111111111111111111111110
1111111111111111111111111111111111111111111111111111111111111111111111111111111100001111111111111110
1111111111111111111111111111111111111111111111111111111111111111111111111111111100001111111111111110
1111111111111111111111111111111111111111111111111111111111111111111111111111111100001111111111111110
1111111111111111111111111111111111111111111111111111111111111111111111111111111100001111111111111110
1111111111111111111111111111111111111111111111111111111111111111111111111110110000000111111111111110
1111111111111111111111111111111111111111111111111111111111111111111111111110110000000111111111111110
1111111111111111111111111111111111111111111111111111111111111111111111111100000000000111111111111110
1111111111111111111111111111111111111111111111111100001111111111111111111100000000000000001111111110
1111111111111110001110011111001111111111111111111000000111111111111111111111000000000000001111111110
1111111111111100000000010000001111111111111111110000000011111111111111111100000000000011001111111110
1111111111111100000000000000001111111111111111110000000000000011111111000000000000000110001111111110
1111111111111101100000000011111111111111111111110000000000000011111111000000000000000110001111111110
1111111111111101100001100011111111111111111111110000000000000011111111000000000000000110001111111110
1111111111111100000001100000001111111111111111110000000000000011111111000000000000000110001111111110
1111111111111100000100001000001111111111111111111001111111111111111111111100000000000011001111111110
1111111111111100000111111000001111111111111111111111111111111111111111111111000000000000001111111110
1111111111111100000011110000001111111111111111111111111111111111111111111100000000000000001111111110
1111111111111100000000000000001111111111111111111111111111111111111111111100000000000011111111111110
1111111111000000000000000000001111111111111111111111111111111111111111111111100011100011111111111110
1111111111000000011110011110001111111111111111111111111111111111111111111111100011100011111111111110
1111111111000000011110011110001111111111111111111111111111111111111111111111111111111111111111111110
1111111111000000000000000000001111111111111111111111111111111111111111111111111111111111111111111110
1111111111111100000000000000001111111111111111111111111111111111111111111111111111111111111111111110
1111111111111100011110011110001111111111111111111111111111111111111111111111111111111111111111111110
1111111111111100011110011110001111111111111111111111111111111111111111111111111111111111111111111110
1111111111111100000000000000001111111111111111111111111111111111111111111111111111111111111111111110
1111111111111100000000000000001111111111111111111111111111111111111111111111111111111111111111111110
1111111111111100011110011110001111111111111111111111111111111111111111111111111111111111111111111110
1111111111111100011110011110001111111111111111111111111111111111111111111111111111111111111111111110
1111111111111100000000000000111111111111111111111111111111111111111111111111111111111111111111111110
1111111111111100000000000000111111111111111111111111111011111111111111111111111111111111111111111110
1111111111111100000000000000111111111111111101101111111011111111111111111111111111111111111111111110
1111111111111111111111111111111111111111111100000000000011111111111111111111111111111111111111111110
1111111111111111111111111111111111111111111100000011000011111111111111111111111111111111111111111110
1111111111111111111111111111111111111111111100001111110000000011111111111111111111111111111111111110
1111111111111111111111111111111111111111111100001111110000000011111111111111111111111111111111111110
1111111111111111111111111111111111111111111100000000000000000011111111111111111111111111111111111110
1111111111111111111111111111111111111111111100000000000000001111111111111111111111111111111111111110
1111111111111111111111111111111111111111111100000000000000001111111111111111111111111111111111111110
1111111111111111111111111111111111111111111100000000000000001111111111111111111111111111111111111110
1111111111111111111111111111111111111111111111110000111111111111111111111111111111111111111111111110
1111111111111111111111111111111111111111111111110000111111111111111111111111111111111111111111111110
1111111111111111111111111111111111111111111111111111111111111111111111111111111111111111111111111110
1111111111111111111111111111111111111111111111111111111111111111111111111111111111111111111111111110
1111111111111111111111111111111111111111111111111111111111111111111111111111111111111111111111111110
1111111111111111111111111111111111111111111111111111111111111111111111111111111111111111111111111110
