00000000000000000000000000000000000000000000000000000000000000000000000000000000
11111111111111111111111111111111111111111111111111111111111111111111111111111110
11111111111111111111111111111111111111111111111111111111111111111111111111111110
11100000000000000000000000000000000000000000000000000000000000000000000000000110
11100000000000000000000000000000000000000000000000000000000000000000000000000110
11100000000000000000000000000000000000000000000000000000000000000000000000000110
11100000000000000000000000000000000000000000000000000000000000000000000000000110
11100000000000000000000000000000000000000000000000000000000000000000000000000110
11100000000000000000000000000000000000000000000000000000000000000000000000000110
11100000000000000000000000000000000000000000000000000000000000000000000000000110
11100000000000000000000000000000000000000000000000000000000000000000000000000110
11100000000000000000000000000000000000000000000000000000000000000000000000000110
11100000000000000000000000000000000000000000000000000000000000000000000000000110
11100000000001111111111111111111111111111111111111111111111111111110000000000110
11100000000001000000000000110000000000000000000000000011000000000010000000000110
11100000000001000000000000110000000000000000000000000011000000000010000000000110
11100000000001000000000000000000000000000000000000000000000000000010000000000110
11100000000001000000000000000000000000000000000000000000000000000010000000000110
11100000000001000055555555555555555555500555001555555555555555000010000000000110
11100000000001000055555555550000000000500555001000000555555555000010000000000110
11100000000001000055555555550000000000500555001000000555555555000010000000000110
11100000000001000055551111110000000000500555001000000555551115000010000000000110
11100000000001000000005000000011110000555555001000000500000005000010000000000110
11100000000001000000005000000011110000000055001000000500000005000010000000000110
11100000000001000050005000000011000000000055001000000500050005000010000000000110
11100000000001000050005000500011000000000055001000000500050005000010000000000110
11100000000001000050005000500000000011110005005000000100050001000010000000000110
11100000000001000050005000500000000011110005005000000100050001000010000000000110
11100000000001110050001000500000000000000000000000000100010001000010000000000110
11100000000001110050001000500000000000000000000000000100010001000010000000000110
11100000000001000010001000500000000000000000000000000100010005000010000000000110
11100000000001000010001000500000000000000000000000000500010005000010000000000110
11100000000001000010005000500000000000000000000011000500050005000010000000000110
11100000000001000010005000100000000000000000000011000500050005000010000000000110
11100000000001000050005000100000000033333333000011000500050000000010000000000110
11100000000001000050005000100000000033333333000011000000050000000010000000000110
11100000000001000050000000100000113311111111330011000000055555000010000000000110
11100000000001000050000000100000113310000001330011000000000005000010000000000110
11100000000001000011111555100000003310000001330000000000055555000010000000000110
11100000000001000000005000000000003310000001330000000000050000000010000000000110
11100000000001000000005000000000003310000001330000000000050000000010000000000110
11100000000001000055555000000000003310000001330000000155511111000010000000000110
11100000000001000050000000000011003310000001331100000100000005000010000000000110
11100000000001000055555000000011003311111111331100000100000005000010000000000110
11100000000001000000005000000011000033333333000000000100050005000010000000000110
11100000000001000000005000500011000033333333000000000100050005000010000000000110
11100000000001000050005000500011000000000000000000000100050001000010000000000110
11100000000001000050005000500011000000000000000000000500050001000010000000000110
11100000000001000050001000500000000000000000000000000500010001000010000000000110
11100000000001000050001000100000000000000000000000000500010001000010000000000110
11100000000001000010001000100000000000000000000000000500010005001110000000000110
11100000000001000010001000100000000000000000000000000500010005001110000000000110
11100000000001000010005000100000050050001111000000000500050005000010000000000110
11100000000001000010005000100000050050001111000000000500050005000010000000000110
11100000000001000050005000500000010055500000000011000500050005000010000000000110
11100000000001000050005000500000010055500000000011000000050005000010000000000110
11100000000001000050000000500000010055500000001111000000050000000010000000000110
11100000000001000050000000500000010055555500001111000000050000000010000000000110
11100000000001000051115555500000010055500500000000001111115555000010000000000110
11100000000001000055555555500000010055500500000000005555555555000010000000000110
11100000000001000055555555500000010055500500000000005555555555000010000000000110
11100000000001000055555555555555510055500555555555555555555555000010000000000110
11100000000001000000000000000000000000000000000000000000000000000010000000000110
11100000000001000000000000000000000000000000000000000000000000000010000000000110
11100000000001000000000011000000000000000000000000001100000000000010000000000110
11100000000001000000000011000000000000000000000000001100000000000010000000000110
11100000000001111111111111111111111111111111111111111111111111111110000000000110
11100000000000000000000000000000000000000000000000000000000000000000000000000110
11100000000000000000000000000000000000000000000000000000000000000000000000000110
11100000000000000000000000000000000000000000000000000000000000000000000000000110
11100000000000000000000000000000000000000000000000000000000000000000000000000110
11100000000000000000000000000000000000000000000000000000000000000000000000000110
11100000000000000000000000000000000000000000000000000000000000000000000000000110
11100000000000000000000000000000000000000000000000000000000000000000000000000110
11100000000000000000000000000000000000000000000000000000000000000000000000000110
11100000000000000000000000000000000000000000000000000000000000000000000000000110
11100000000000000000000000000000000000000000000000000000000000000000000000000110
11111111111111111111111111111111111111111111111111111111111111111111111111111110
11111111111111111111111111111111111111111111111111111111111111111111111111111110
11111111111111111111111111111111111111111111111111111111111111111111111111111110
