0000000000000000000000000000000000000000000000000000000000000000000000000000000000000000000000000000000000000000000000000000000000000000000000000000000000000000
1111111111111111111111111111111111111111111111111111111111111111111111111111111111111111111111111111111111111111111111111111111111111111111111111111111111111110
1111111111111111111111111111111111111111111111111111111111111111111111110000111111111111111111111111111111111111111111111111111111111111111111111111111111111110
1111111111111111111111111111111111111111111111111111111111111111111111110000111111111111111111111111111111111111111111111111111111111111111111111111111111111110
1111110000000000000000000011111111111111111111111111111111111111111001000000111111111111111111111111111111111111111111111111111111111111111111111111111111111110
1111110000000000000000000011111111111111111111111111111111111111111001000000111111111111111111111111111111111111111111111111111111111111111111111111111111111110
1111110000000000000000000011111111111111111111111111111111111111001001000000111111111111110011111111111111111111111111111111111111111111111111111111111111111110
1111110000000000000000000011111111111111111111111111111111111111000000000000111111111111110011111111111111111111111111111111111111111111111111111111111111111110
1111111111111111111111000011111111111111111111111111111111111111000000000000000000000000000011111111111111111111111111111111111111111111111111111111111111111110
1111111111111111111111000011111111111111111111111111111111111111000000000000000000000000000011111111111111111111111111111111111111111111111111111111111111111110
1111111111111111111111000011111111111111111111111111111111111111000010100000000000000000000011111111111111111111111111111111111111111111111111111111111111111110
1111111111111111111111000011111111111111111111111111111111111111000000000000000000000000001111111111111111111111111111111111111111111111111111111111111111111110
1111111111111111111111000011111111111111111111111111111111111111001111110000000111000000001111111111111111111111111111111111111111111111111111111111111111111110
1111111111111111111111000011111111111111111111111111111111111111001111110000010111010000001111111111111111111111111111111111111111111111111111111111111111111110
1111111111111111111111000011111111111111111111111111111111111111001111110000000111000000001111111111111111111111111111111111111111111111111111111111111111111110
1111111111111111111111000011111111111111111111111111111111111111000000000000100111010000001111111111111111111111111111111111111111111111111111111111111111111110
1111111111111111111111000011111111111111111111111111111111111111000010100001100111000000000011111111111111111111111111111111111111111111111111111111111111111110
1111111111111111111111000011111111111111111111111111111111111111000000000000000111000000000011111111111111111111111111111111111111111111111111111111111111111110
1111111111111111111111000011111111111111111111111111111111111111111111111111111111000000001111111111111111111111111111111111111111111111111111111111111111111110
1111111111111111111111000011111111111111111111111111111111111111111111111111111111000000001111111111111111111111111111111111111111111111111111111111111111111110
1111110000000000000000000011111111111111111111111111111111111111111111111111111100000000001111111111111111111111111111111111111111111111111111111111111111111110
1111110000000000000000000011111111111111111111111111111111111111111111111111111100000000001111111111111111111111111111111111111111111111111111111111111111111110
1111110000000000000000000011111111111111111111111111111111111111111111111111111100000000001111111111111111111111111111111111111111111111111111111111111111111110
1111110000000000000000000011111111111111111111111111111111111111111111111111111100000000001111111111111111111111111111111111111111111111111111111111111111111110
1111110000111111111111111111111111111111111111111111111111111111111111111111111111000000001111111111111111111111111111111111111111111111111111111111111111111110
1111110000111111111111111111111111111111111111111111111111111111111111111111111111000000001111111111111111111111111111111111111111111111111111111111111111111110
1111110000111111111111111111111111111111111111111111111111111111111111111111111111111111111111111111111111111111111111111111111111111111111111111111111111111110
1111110000111111111111111111111111111111111111111111111111111111111111111111111111111111111111111111111111111111111111111111111111111111111111111111111111111110
1111110000111111111111111111111111111111111111111111111111111111111111111111111111111111111111111111111111111111111111111111111111111111111111111111111111111110
1111110000111111111111111111111111111111111111111111111111111111111111111111111111111111111111111111111111111111111111111111111111111111111111111111111111111110
1111110000111111111111111111111111111111111111111111111111111111111111111111111111111111111111111111111111111111111111111111111111111111111111111111111111111110
1111110000111111111111111111111111111111111111111111111111111111111111111111111111111111111111111111111111111111111111111111111111111111111111111111111111111110
1111110000111111111111111111111111111111111111111111111111111111111111111111111111111111111111111111111111111111111111111111111111111111111111111111111111111110
1111110000111111111111111111111111111111111111111111111111111111111111111111111111111111111111111111111111111111111111111111111111111111111111111111111111111110
1111110000111111111111111111111111111111111111111111111111111111111111111111111111111111111111111111111111111111111111111111111111111111111111111111111111111110
1111110000111111111111111111111111111111111111111111111111111111111111111111111111111111111111111111111111111111111111111111111111111111111111111111111111111110
1111110000000000000011111111111111111111111111111111111111111111111111111111111111111111111111111111111111111111111111111111111111111111111111111111111111111110
1111110000000000000011111111111111111111111111111111111111111111111111111111111111111111111111111111111111111111111111111111111111111111111111111111111111111110
1111110000000000000011111111111111111111111111111111111111111111111111111111111111111111111111111111111111111111111111111111111111111111111111000011111111111110
1111110000000000000011111111111111111111111111111111111111111111111111111111111111111111111111111111111111111111111111111111111111111111111111000011111111111110
1111111111111111000011111111111111111111111111111111111111111111111111111111111111111111111111111111111111111111111111111111111111111111111111000011111111111110
1111111111111111000011111111111111111111111111111111111111111111111111111111111111111111111111111111111111111111111111111111111111111111111111000011111111111110
1111111111111111000011111111111111111111111111111111111111111111111111111111111111111111111111111111111111111111111111111111111111111111111111000000111111111110
1111111111111111000011111111111111111111111111111111111111111111111111111111111111111111111111111111111111111111111111111111111111111111110000000000111111111110
1111111111111111000011111111111111111111111111111100001111111111111111111111111111111111111111111111111111111111111111111111111111111111110000010000001111111110
1111111111111111000011111111111111111111111111111100001111111111111111111111111111111111111111111111111111111111111111111111111111111111110000000000001111111110
1111111111111111000011111111111111111111111111110000000000000000111111111111111111111111111111111111111111111111111111111111111111111111110001111100001111111110
1111111111111111000011111111111111111111111111110000000000000000111111111111111111111111111111111111111111111111111111111111111111111111110001111100000011111110
1111111111111111000011111111111111111111111111110000000000000000001111111111111111111111111111111111111111111111111111111111111111111111110001111100000011111110
1111111111111111000011111111111111111111111111110000000000000000001111111111111111111111111111111111111111111111111111111111111111111111110000000000000011111110
1111111111111111000011111111111111111111111111110000000000000000001111111111111111111111111111111111111111111111111111111111111111111111110000101000000011111110
1111111111111111000011111111111111111111111111110000000000000000001111111111111111111111111111111111111111111111111111111111111111111111110000000000000011111110
1111111111111111111111111111111111111111111111110000000000000000111111111111111111111111111111111111111111111111111111111111111111111111111111110000000011111110
1111111111111111111111111111111111111111111111110000000000000000111111111111111111111111111111111111111111111111111111111111111111111111111111110000000011111110
1111111111111111111111111111111111111111111111111100001111111111111111111111111111111111111111111111111111111111111111111111111111111111111111110000001111111110
1111111111111111111111111111111111111111111111111100001111111111111111111111111111111111111111111111111111111111111111111111111111111111111111110000001111111110
1111111111111111111111111111111111111111111111111111111111111111111111111111111111111111111111111111111111111111111111111111111111111111111111110000001111111110
1111111111111111111111111111111111111111111111111111111111111111111111111111111111111111111111111111111111111111111111111111111111111111111111110000001111111110
1111111111111111111111111111111111111111111111111111111111111111111111111111111111111111111111111111111111111111111111111111111111111111111111110000111111111110
1111111111111111111111111111111111111111111111111111111111111111111111111111111111111111111111111111111111111111111111111111111111111111111111110000111111111110
1111111111111111111111111111111111111111111111111111111111111111111111111111111111111111111111111111111111111111111111111111111111111111111111111111111111111110
1111111111111111111111111111111111111111111111111111111111111111111111111111111111111111111111111111111111111111111111111111111111111111111111111111111111111110
1111111111111111111111111111111111111111111111111111111111111111111111111111111111111111111111111111111111111111111111111111111111111111111111111111111111111110
1111111111111111111111111111111111111111111111111111111111111111111111111111111111111111111111111111111111111111111111111111111111111111111111111111111111111110
1111111111111111111111111111111111111111111111111111111111111111111111111111111111111111111111111111111111111111111111111111111111111111111111111111111111111110
1111111111111111111111111111111111111111111111111111111111111111111111111111111111111111111111111111111111111111111111111111111111111111111111111111111111111110
1111111111111111111111111111111111111111111111111111111111111111111111111111111111111111111111111111111111111111111111111111111111111111111111111111111111111110
1111111111111111111111111111111111111111111111111111111111111111111111111111111111111111111111111111111111111111111111111111111111111111111111111111111111111110
1111111111111111111111111111111111111111111111111111111111111111111111111111111111111111111111111111111111111111111111111111111111111111111111111111111111111110
1111111111111111111111111111111111111111111111111111111111111111111111111111111111111111111111111111111111111111111111111111111111111111111111111111111111111110
1111111111111111111111111111111111111111111111111111111111111111111111111111111111111111111111111111111111111111111111111111111111111111111111111111111111111110
1111111111111111111111111111111111111111111111111111111111111111111111111111111111111111111111111111111111111111111111111111111111111111111111111111111111111110
1111111111111111111111111111111111111111111111111111111111111111111111111111110000111111111111111111111111111111111111111111111111111111111111111111111111111110
1111111111111111111111111111111111111111111111111111111111111111111111111111110000111111111111111111111111111111111111111111111111111111111111111111111111111110
1111111111111111111111111111111111111111111111111111111111111111111111111111110000111111111111111111111111111111111111111111111111111111111111111111111111111110
1111111111111111111111111111111111111111111111111111111111111111111111111111110000111111111111111111111111111111111111111111111111111111111111111111111111111110
1111110111101111111111111111111111111111111111111111111111111111111111111111110000001111111111111111111111111111111111111111111111111111111111111111111111111110
1111110111101111111111111111111111111111111111111111111111111111111111111111110000001111111111111111111111111111111111111111111111111111111111111111111111111110
1111110000001111111111111111111111111111111111111111111111111111111111111100000100000011111111111111111111111111111111111111111111111111111111111111111111111110
1111110000001111111111111111111111111111111111111111111111111111111111111100000000000011111111111111111111111111111111111111111111111111111111111111111111111110
1111110000001111111111111111111111111111111111111111111111111111111111111100011111000011111111111111111111111111111111111111111111111111111111111111111111111110
1111110000001100000011111111111111111111111111111111111111111111111111111100011111000000111111111111111111111111111111111111111111111111111111111111111111111110
1111110000000000000011111111111111111111111111111111111111111111111111111100011111000000111111111111111111111111111111111111111111111111111111111111111111111110
1111110000000000000011111111111111111111111111111111111111111111111111111100000000000000111111111111111111111111111111111111111111111111111111111111111111111110
1111110000101010000011111111111111111111111111111111111111111111111111111100001010000000111111111111111111111111111111111111111111111111111111111111111111111110
1111110000000000000011111111111111111111111111111111111111111111111111111100000000000000111111111111111111111111111111111111111111111111111111111111111111111110
1111110011111111100011111111111111111111111111111111111111111111111111111111111100000000111111111111111111111111111111111111111111111111111111111111111111111110
1111110011111111100011111111111111111111111111111111111111111111111111111111111100000000111111111111111111111111111111111111111111111111111111111111111111111110
1111110011111111100011111111111111111111111111111111111111111111111111111111111100000011111111111111111111111111111111111111111111111111111111111111111111111110
1111110000000000000011111111111111111111111111111111111111111111111111111111111100000011111111111111111111111111111111111111111111111111111111111111111111111110
1111110000101010000011111111111111111111111111111111111111111111111111111111111100000011111111111111111111111111111111111111111111111111111111111111111111111110
1111110000000000000011111111111111111111111111111111111111111111111111111111111100000011111111111111111111111111111111111111111111111111111111111111111111111110
1111110000000000000011111111111111111111111111111111111111111111111111111111111100001111111111111111111111111111111111111111111111111111111111111111111111111110
1111110000000000000011111111111111111111111111111111111111111111111111111111111100001111111111111111111111111111111111111111111111111111111111111111111111111110
1111111111000011111111111111111111111111111111111111111111111111111111111111111111111111111111111111111111111111111111111111111111111111111111111111111111111110
1111111111000011111111111111111111111111111111111111111111111111111111111111111111111111111111111111111111111111111111111111111111111111111111111111111111111110
1111111111111111111111111111111111111111111111111111111111111111111111111111111111111111111111111111111111111111111111111111111111111111111111111111111111111110
1111111111111111111111111111111111111111111111111111111111111111111111111111111111111111111111111111111111111111111111111111111111111111111111111111111111111110
1111111111111111111111111111111111111111111111111111111111111111111111111111111111111111111111111111111111111111111111111111111111111111111111111111111111111110
1111111111111111111111111111111111111111111111111111111111111111111111111111111111111111111111111111111111111111111111111111111111111111111111111111111111111110
