00000000000000000000000000000000000000000000000000000000000000000000000000000000000000000000000000000000000000000000000000000000000000000000000000000000000000000000000000000000000000000000000000000000
11111111111111111111111111111111111111111111111111111111111111111111111111111111111111111111111111111111111111111111111111111111111111111111111111111111111111111111111111111111111111111111111111111110
11111111111111111111111111111111111111111111111111111111111111111111111111111111111111111111111111111111111111111111111111111111111111111111111111111111111111111111111111111111111111111111111111111110
11111111111111111111111111111111111111111111111111111111111111111111111111111111111111111111111111111111111111111111111111111111111111111111111111111111111111111111111111111111111111111111111111111110
11111111111111111111111111111111111111111111111111111111111111111111111111111111111111111111111111111111111111111111111111111111111111111111111111111111111111111111111111111111111111111111111111111110
11111111111111111111111111111111111111111111111111111111111111111111111111111111111111111111111111111111111111111111111111111111111111111111111111111111111111111111111111111111111111111111111111111110
11111111111111111111111111111111111111111111111111111111111111111111111111111111111111111111111111111111111111111111111111111111111111111111111111111111111111111111111111111111111111111111111111111110
11111111111111111111111111111111111111111111111111111111111111111111111111111111111111111111111111111111111111111111111111111111111111111111111111111111111111111111111111111111111111111111111111111110
11111111111111111111111111111111111111111111111111111111111111111111111111111111111111111111111111111111111111111111111111111111111111111111111111111111111111111111111111111111111111111111111111111110
11111111111111111111111111111111111111111111111111111111111111111111111111111111111111111111111111111111111111111111111111111111111111111111111111111111111111111111111111111111111111111111111111111110
11111111111111111111111111111111111111111111111111111111111111111111111111111111111111111111111111111111111111111111111111111111111111111111111111111111111111111111111111111111111111111111111111111110
11111111111111111111111111111111111111111111111111111111111111111111111111111111111111111111111111111111111111111111111111111111111111111111111111111111111111111111111111111111111111111111111111111110
11111111111111111111111111111111111111111111111111111111111111111111111111111111111111111111111111111111111111111111111111111111111111111111111111111111111111111111111111111111111111111111111111111110
11111111111111111111111111111111111111111111111111111111111111111111111111111111111111111111111111111111111111111111111111111111111111111111111111111111111111111111111111111111111111111111111111111110
11111111111111111111111111111111111111111111111111111111111111111111111111111111111111111111111111111111111111111111111111111111111111111111111111111111111111111111111111111111111111111111111111111110
11111111111111111111111111111111111111111111111111111111111111111111111111111111111111111111111111111111111111111111111111111111111111111111111111111111111111111111111111111111111111111111111111111110
11111111111111111111111111111111111111111111111111111111111111111111111111111111111111111111111111111111111111111111111111111111111111111111111111111111111111111111111111111111111111111111111111111110
11111111111111111111111111111111111111111111111111111111111111111111111111111111111111111111111111111111111111111111111111111111111111111111111111111111111111111111111111111111111111111111111111111110
11111111111111111111111111111111111111111111111111111111111111111111111111111111111111111111111111111111111111111111111111111111111111111111111111111111111111111111111111111111111111111111111111111110
11111111111111111111111111111111111111111111111111111111111111111111111111111111111111111111111111111111111111111111111111111111111111111111111111111111111111111111111111111111111111111111111111111110
11111111111111111111111111111111111111111111111111111111111111111111111111111111111111111111111111111111111111111111111111111111111111111111111111111111111111111111111111111111111111111111111111111110
11111111111111111111111111111111111111111111111111111111111111111111111111111111111111111111111111111111111111111111111111111111111111111111111111111111111111111111111111111111111111111111111111111110
11111111111111111111111111111111111111111111111111111111111111111111111111111111111111111111111111111111111111111111111111111111111111111111111111111111111111111111111111111111111111111111111111111110
11111111111111111111111111111111111111111111111111111111111111111111111111111111111111111111111111111111111111111111111111111111111111111111111111111111111111111111111111111111111111111111111111111110
11111111111111111111111111111111111111111111111111111111111111111111111111111111111111111111111111111111111111111111111111111111111111111111111111111111111111111111111111111111111111111111111111111110
11111111111111111111111111111111111111111111111111111111111111111111111111111111111111111111111111111111111111111111111111111111111111111111111111111111111111111111111111111111111111111111111111111110
11111111111111111111111111111111111111111111111111111111111111111111111111111111111111111111111111111111111111111111111111111111111111111111111111111111111111111111111111111111111111111111111111111110
11111111111111111111111111111111111111111111111111111111111111111111111111111111111111111111111111111111111111111111111111111111111111111111111111111111111111111111111111111111111111111111111111111110
11111111111111111111111111111111111111111111111111111111111111111111111111111111111111111111111111111111111111111111111111111111111111111111111111111111111111111111111111111111111111111111111111111110
11111111111111111111111111111111111111111111111111111111111111111111111111111111111111111111111111111111111111111111111111111111111111111111111111111111111111111111111111111111111111111111111111111110
11111111111111111111111111111111111111111111111111111111111111111111111111111111111111111111111111111111111111111111111111111111111111111111111111111111111111111111111111111111111111111111111111111110
11111111111111111111111111111111111111111111111111111111111111111111111111111111111111111111111111111111111111111111111111111111111111111111111111111111111111111111111111111111111111111111111111111110
11111110000000000000000000000000000000111111111111111111111111111111111111111111111111111111111111111111111111111111111111111000000000000000000000000000000011111111111111111111111111111111111111111110
11111110000000000000000000000000000000111111111111111111111111111111111111111111111111111111111111111111111111111111111111111000000000000000000000000000000011111111111111111111111111111111111111111110
11111110000000000000000000000000000000111111111111111111111111111111111111111111111111111111111111111111111111111111111111111000000000000000000000000000000011111111111111111111111111111111111111111110
11111110000000000000000000000000000000111111111111111111111111111111111111111111111111111111111111111111111111111111111111111000000000000000000000000000000011111111111111111111111111111111111111111110
11111111000000000000000000000000000000111111111111111111111111111111111111111111111111111111111111111111111111111111111111111100000000000000000000000000000011111111111111111111111111111111111111111110
11111111000000000000000000000000000000111111111111111111111111111111111111111111111111111111111111111111111111111111111111111100000000000000000000000000000011111111111111111111111111111111111111111110
11111110000000000000000000000000000000111111111111111111111111111111111111111111111111111111111111111111111111111111111111111000000000000000000000000000000011111111111111111111111111111111111111111110
11111110000000000000000000000000000000111111111111111111111111111111111111111111111111111111111111111111111111111111111111111000000000000000000000000000000011111111111111111111111111111111111111111110
11111110000000000000000000000000000000111111111111111111111111000000001111111111111111111111111111111111111111111111111111111000000000000000000000000000000011111111111111111111111100000000111111111110
11111110000000000000000000000000000000111111111111111111111111000000001111111111111111111111111111111111111111111111111111111000000000000000000000000000000011111111111111111111111100000000111111111110
11111111000000000000000000000000000000111111111111111111111111000000001111111111111111111111111111111111111111111111111111111100000000000000000000000000000011111111111111111111111100000000111111111110
11111111000000000000000000000000000000111111111111111111111111000000001111111111111111111111111111111111111111111111111111111100000000000000000000000000000011111111111111111111111100000000111111111110
11111110000000000000000000000000000000111111111111111111111110000000001111111111111111111111111111111111111111111111111111111000000000000000000000000000000011111111111111111111111100000000111111111110
11111110000000000000000000000000000000111111111111111111111100000000001111111111111111111111111111111111111111111111111111111000000000000000000000000000000011111111111111111111110000000000111111111110
11111110000000000000000000000000000000111111111111111111111000000000001111111111111111111111111111111111111111111111111111111000000000000000000000000000000011111111111111111110000000000000111111111110
11111110000000000000000000000000000000111111111111111111110000000000001111111111111111111111111111111111111111111111111111111000000000000000000000000000000011111111111111111000000000000000111111111110
11111111111111111100000000000000111111111111111111111100000000000011111111111111111111111111111111111111111111111111111111111111111111000000000000000000001111111111111111110000000000111111111111111110
11111111111111111111000000000001111111111111111111111100000000000111111111111111111111111111111111111111111111111111111111111111111111110000000000000000111111111111111111110000000011111111111111111110
11111111111111111111100000000001111111111111111111111100000000001111111111111111111111111111111111111111111111111111111111111111111111111000000000000011111111111111111111110000000011111111111111111110
11111111111111111111100000000011111111111111111111111100000000011111111111111111111111111111111111111111111111111111111111111111111111111100000000000111111111111111111111110000000011111111111111111110
11111111111111111111110000000011111111111111111111111100000000011111111111111111111111111111111111111111111111111111111111111111111111111110000000000111111111111111111111110000000011111111111111111110
11111111111111111111110000000011111111111111111111111100000000111111111111111111111111111111111111111111111111111111111111111111111111111110000000001111111111111111111111110000000011111111111111111110
11111111111111111111110000000011111111111111111111111100000000111111111111111111111111111111111111111111111111111111111111111111111111111111000000001111111111111111111111110000000011111111111111111110
11111111111111111111110000000011111111111111111111111100000000111111111111111111111111111111111111111111111111111111111111111111111111111111000000001111111111111111111111110000000011111111111111111110
11111111111111111111110000000011111111111111111111111111000000111111111111111111111111111111111111111111111111111111111111111111111111111111000000001111111111111111111111111111000011111111111111111110
11111111111111111111110000000011111111111111111111111111110000011111111111111111111111111111111111111111111111111111111111111111111111111111000000001111111111111111111111111111100001111111111111111110
11111111111111111111110000000011111111111111111111111111111000011111111111111111111111111111111111111111111111111111111111111111111111111111000000001111111111111111111111111111110001111111111111111110
11111111111111111111110000000011111111111111111111111111111100011111111111111111111111111111111111111111111111111111111111111111111111111111000000001111111111111111111111111111110001111111111111111110
11111111111111111111110000000011111111111111111111111111111100011111111111111111111111111111111111111111111111111111111111111111111111111111000000001111111111111111111111111111111001111111111111111110
11111111111111111111110000000011111111111111111111111111111110001111111111111111111111111111111111111111111111111111111111111111111111111111000000001111111111111111111111111111111000111111111111111110
11111111111111111111110000000011111111111111111111111111111110000111111111111111111111111111111111111111111111111111111111111111111111111111000000001111111111111111111111111111111000011111111111111110
11111111111111111111110000000011111111111111111111111111111110000001111111111111111111111111111111111111111111111111111111111111111111111111000000001111111111111111111111111111111100000111111111111110
11111111111111111111110000000011111111111111111111111111111110000000001111111111111111111111111111111111111111111111111111111111111111111111000000001111111111111111111111111111111100000000111111111110
11111111111111111111110000000011111111111111111111111111111110000000001111111111111111111111111111111111111111111111111111111111111111111111000000001111111111111111111111111111111100000000111111111110
11111111111111111111110000000011111111111111111111111111111110000000001111111111111111111111111111111111111111111111111111111111111111111111000000001111111111111111111111111111111100000000111111111110
11111111111111111111110000000011111111111111111111111111111100000000001111111111111111111111111111111111111111111111111111111111111111111111000000001111111111111111111111111111111100000000111111111110
11111111111111111111110000000011111111111111111111111111111100000000001111111111111111111111111111111111111111111111111111111111111111111111000000000111111111111111111111111111111000000000111111111110
11111111111111111111110000000011111111111111111111111111111000000000001111111111111111111111111111111111111111111111111111111111111111111111000000000111111111111111111111111111110000000000111111111110
11111111111111111111110000000000111111111111111111111111111000000000001111111111111111111111111111111111111111111111111111111111111111111111000000000001111111111111111111111111100000000000111111111110
11111111111111111111110000000000001111111111111111111111100000000000001111111111111111111111111111111111111111111111111111111111111111111111000000000000011111111111111111111110000000000000111111111110
11111111111111111111111110000000000011111111111111111100000000000011111111111111111111111111111111111111111111111111111111111111111111111111111100000000000111111111111111110000000000001111111111111110
11111111111111111111111111000000000001111111111111111100000000000111111111111111111111111111111111111111111111111111111111111111111111111111111110000000000111111111111111110000000000111111111111111110
11111111111111111111111111100000000000111111111111111100000000001111111111111111111111111111111111111111111111111111111111111111111111111111111111100000000011111111111111110000000000111111111111111110
11111111111111111111111111110000000000111111111111111100000000011111111111111111111111111111111111111111111111111111111111111111111111111111111111100000000001111111111111110000000001111111111111111110
11111111111111111111111111111100000000111111111111111100000000111111111111111111111111111111111111111111111111111111111111111111111111111111111111110000000001111111111111100000000001111111111111111110
11111111111111111111111111111100000000011111111111111000000000111111111111111111111111111111111111111111111111111111111111111111111111111111111111110000000000011111111111000000000011111111111111111110
11111111111111111111111111111100000000000111111111110000000000111111111111111111111111111111111111111111111111111111111111111111111111111111111111110000000000001111111111000000000011111111111111111110
11111111111111111111111111111100000000000000111111100000000000111111111111111111111111111111111111111111111111111111111111111111111111111111111111110000000000000001111110000000000011111111111111111110
11111111111111111111111111111111111110000000000000000000000000111111111111111111111111111111111111111111111111111111111111111111111111111111111111111111111100000000000000000000000011111111111111111110
11111111111111111111111111111111111111110000000000000000000000111111111111111111111111111111111111111111111111111111111111111111111111111111111111111111111111100000000000000000000011111111111111111110
11111111111111111111111111111111111111111110000000000000000000111111111111111111111111111111111111111111111111111111111111111111111111111111111111111111111111111000000000000000000011111111111111111110
11111111111111111111111111111111111111111111000000000000000000111111111111111111111111111111111111111111111111111111111111111111111111111111111111111111111111111100000000000000000011111111111111111110
11111111111111111111111111111111111111111111100000000000000000111111111111111111111111111111111111111111111111111111111111111111111111111111111111111111111111111110000000000000000011111111111111111110
11111111111111111111111111111111111111111111110000000000000000111111111111111111111111111111111111111111111111111111111111111111111111111111111111111111111111111111000000000000000011111111111111111110
11111111111111111111111111111111111111111111110000000000000000111111111111111111111111111111111111111111111111111111111111111111111111111111111111111111111111111111000000000000000011111111111111111110
11111111111111111111111111111111111111111111110000000000000000111111111111111111111111111111111111111111111111111111111111111111111111111111111111111111111111111111000000000000000011111111111111111110
11111111111111111111111111111111111111111111111111111111111111111111111111111111111111111111111111111111111111111111111111111111111111111111111111111111111111111111111111111111111111111111111111111110
11111111111111111111111111111111111111111111111111111111111111111111111111111111111111111111111111111111111111111111111111111111111111111111111111111111111111111111111111111111111111111111111111111110
11111111111111111111111111111111111111111111111111111111111111111111111111111111111111111111111111111111111111111111111111111111111111111111111111111111111111111111111111111111111111111111111111111110
11111111111111111111111111111111111111111111111111111111111111111111111111111111111111111111111111111111111111111111111111111111111111111111111111111111111111111111111111111111111111111111111111111110
11111111111111111111111111111111111111111111111111111111111111111111111111111111111111111111111111111111111111111111111111111111111111111111111111111111111111111111111111111111111111111111111111111110
11111111111111111111111111111111111111111111111111111111111111111111111111111111111111111111111111111111111111111111111111111111111111111111111111111111111111111111111111111111111111111111111111111110
11111111111111111111111111111111111111111111111111111111111111111111111111111111111111111111111111111111111111111111111111111111111111111111111111111111111111111111111111111111111111111111111111111110
11111111111111111111111111111111111111111111111111111111111111111111111111111111111111111111111111111111111111111111111111111111111111111111111111111111111111111111111111111111111111111111111111111110
11111111111111111111111111111111111111111111111111111111111111111111111111111111111111111111111111111111111111111111111111111111111111111111111111111111111111111111111111111111111111111111111111111110
11111111111111111111111111111111111111111111111111111111111111111111111111111111111111111111111111111111111111111111111111111111111111111111111111111111111111111111111111111111111111111111111111111110
11111111111111111111111111111111111111111111111111111111111111111111111111111111111111111111111111111111111111111111111111111111111111111111111111111111111111111111111111111111111111111111111111111110
11111111111111111111111111111111111111111111111111111111111111111111111111111111111111111111111111111111111111111111111111111111111111111111111111111111111111111111111111111111111111111111111111111110
