1111111111111111111111111111111111111111111111111111111111111111111111111111111111111111111111111111
1111111111111111111111111111111111111111111111111111111111111111111111111111111111111111111111111111
1111111111111111111111111111111111111111111111111111111111111111111111111111111111111111111111111111
1111111111111111111111111111111111111111111111111111111111111111111111111111111111111111111111111111
1111111111111111111111111111111111111111111111111111111111111111111111111111111111111111111111111111
1111111111111111111111111111111111111111111111111111111111111111111111111111111111111111111111111111
1111111111111111111111111111111111111100000111111111111111111111111111111111111111111111111111111111
1111111111111111111111111111111111111100000011111111111111111111111111111111111111111111111111111111
1111111111111111111111111111111111111111100000000000001111111111111111111111111111111111111111111111
1111111111111111111111111111111111111111100000000000001111111111111111111111111111111111111111111111
1111111111111111111111111111111111111111100100100100001111111111111111111111111111111111111111111111
1111111111111111111111111111111111111111100100000001001111111111111111111111111111111111111111111111
1111111111111111111111111111111111111111100100000000001111111111111111111111111111111111111111111111
1111111111111111111111111111111111111111100000000000001111111111111111111111111111111111111111111111
1111111111111111111111111111111111111100000000000001001111111111111111111111111111111111111111111111
1111111111111111111111111111111111111100000000000000001111111111111111111111111111111111111111111111
1111111111111111111111111111111111111111111111111111111111111111111111111111111111111111111111111111
1111111111111111111111111111111111111111111111111111111111111111111111111111111111111111111111111111
1111111111111111111111111111111111111111111111111111111111111111111111111111111111111111111111111111
1111111111111111111111111111111111111111111111111111111111111111111111111111111111111111111111111111
1111111111111111111111111111111111111111111111111111111111111111111111111111111111111111111111111111
1111111111111111111111111111111111111111111111111111111111111111111111111111111111111111111111111111
1111111111111111111111111111111111111111111111111111111111111111111111111111111111111111111111111111
1111111111111111111111111111111111111111111111111111111111111111111111111111111111111111111111111111
1111111111111111111111111111111111111111111111111111111111111111111111111111111111111111111111111111
1111111111111111111111111111111111111111111111111111111111111111111111111111111111111111111111111111
1111111111111111111111111111111111111111111111111111111111111111111111111111111111111111111111111111
1111111111111111111111111111111111111111111111111111111111111111111111111111111111111111111111111111
1111111111111111111111111111111111111111111111111111111111111111111111111111111111111111111111111111
1111111111111111111111111111111111111111111111111111111111111111111111111111111111111111111111111111
1111111111111111111111111111111111111111111111111111111111111111111111111111111111111111111111111111
1111111111111111111111111111111111111111111111111111111111111111111111111111111111111111111111111111
1111111111111111111111111111111111111111111111111111111111111111111111111111111111111111111111111111
1111111111111111111111111111111111111111111111111111111111111111111111111111111111111111111111111111
1111111111111111111111111111111111111111111111111111111111111111111111111111111111111111111111111111
1111111111111111111111111111111111111111111111111111111111111111111111111111111111111111111111111111
1111111111111111111111111111111111111111111111111111111111111111111111111111111111111111111111111111
1111111111111111111111111111111111111111111111111111111111111111111111111111111111111111111111111111
1111111111111111111111111111111111111111111111111111111111111111111111111111111111111111111111111111
1111111111111111111111111111111111111111111111111111111111111111111111111111111111111111111111111111
1111111111111111111111111111111111111111111111111111111111111111111111111111111111111111111111111111
1111111111111111111111111111111111111111111111111111111111111111111111111111111111111111111111111111
1111111111111111111111111111111111111111111111111111111111111111111111111111111111111111111111111111
1111111111111111111111111111111111111111111111111111111111111111111111111111111111111111111111111111
1111111111111111111111111111111111111111111111111111111111111111111111111111111111111111111111111111
1111111111111111111111111111111111111111111111111111111111111111111111111111111111111111111111111111
1111111111111111111111111111111111111111111111111111111111111111111111111111111111111111111111111111
1111111111111111111111111111111111111111111111111111111111111111111111111111111111111111111111111111
1111111111111111111111111111111111111111111111111111111111111111111111111111111111111111111111111111
1111111111111111111111111111111111111111111111111111111111111111111111111111111111111111111111111111
1111111111111111111111111111111111111111111111111111111111111111111111111111111111111111111111111111
1111111111111111111111111111111111111111111111111111111111111111111111111111111111111111111111111111
1111111111111111111111111111111111111111111111111111111111111111111111111111111111111111111111111111
1111111111111111111111111111111111111111111111111111111111111111111111111111111111111111111111111111
1111111111111111111111111111111111111111111111111111111111111111111111111111111111111111111111111111
1111111111111111111111111111111111111111111111111111111111111111111111111111111111111111111111111111
1111111111111111111111111111111111111111110000000000000000111111111111111111111111111111111111111111
1111111111111111111111111111111111111111110000000000000000111111111111111111111111111111111111111111
1111111111111111111111111111111111111111110000000000000000111111111111111111111111111111111111111111
1111111111111111111111111111111111111111110000000000000000111111111111111111111111111111111111111111
1111111111111111111111111111111111111111110000000000000000111111111111111111111111111111111111111111
1111111111111111111111111111111111111111110000000000000000111111111111111111111111111111111111111111
1111111111111111111111111111111111111111110000000000000000111111111111111111111111111111111111111111
1111111111111111111111111111111111111111110000000000000000111111111111111111111111111111111111111111
1111111111111111111111111111110000000000110000000000000000110000000000111111111111111111111111111111
1111111111111111111111111111110000000000110000000000000000110000000000111111111111111111111111111111
1111111111111111111111111111110000000000111111111111111111110000000000111111111111111111111111111111
1111111111111111111111111111110000000000111111111111111111110000000000111111111111111111111111111111
1111111111111111111111111111110000000000000000000000000000000000000000111111111111111111111111111111
1111111111111111111111111111110000000000000000000000000000000000000000111111111111111111111111111111
1111111111111111111111111111110000000000000000000000000000000000000000111111111111111111111111111111
1111111111111111111111111111110000000000000000000000000000000000000000111111111111111111111111111111
1111111111111111111111111111110000000000000000011111000000000000000000111111111111111111111111111111
1111111111111111111111111111110000000000000000010001000000000000000000111111111111111111111111111111
1111111111111111111111111111110000000000000000010001000000000000000000111111111111111111111111111111
1111111111111111111111111111110000000000000000010001000000000000000000111111111111111111111111111111
1111111111111111111111111111110000000000000111111111111100000000000000111111111111111111111111111111
1111111111111111111111111111110000000000000100011111000100000000000000111111111111111111111111111111
1111111111111111111111111111110000000000000100011111000100000000000000111111111111111111111111111111
1111111111111111111111111111110000000000000100011111000100000000000000111111111111111111111111111111
1111111111111111111111111111110000000000000111111111111100000000000000111111111111111111111111111111
1111111111111111111111111111110000000000000011111111110000000000000000111111111111111111111111111111
1111111111111111111111111111110000000000000010001100010000000000000000111111111111111111111111111111
1111111111111111111111111111110000000000000010001100010000000000000000111111111111111111111111111111
1111111111111111111111111111110000000000000010001100010000000000000000111111111111111111111111111111
1111111111111111111111111111110000000000000011111111110000000000000000111111111111111111111111111111
1111111111111111111111111111110000000000000000000000000000000000000000111111111111111111111111111111
1111111111111111111111111111110000000000000000000000000000000000000000111111111111111111111111111111
1111111111111111111111111111110000000000000000000000000000000000000000111111111111111111111111111111
1111111111111111111111111111110000000000000000000000000000000000000000111111111111111111111111111111
1111111111111111111111111111110000000000000000000000000000000000000000111111111111111111111111111111
1111111111111111111111111111110000000000000000000000000000000000000000111111111111111111111111111111
1111111111111111111111111111111100000011111111111111111111111111111111111111111111111111111111111111
1111111111111111111111111111111100000011111111111111111111111111111111111111111111111111111111111111
1111111111111111111111111111111100000011111111111111111111111111111111111111111111111111111111111111
1111111111111111111111111111111100000011111111111111111111111111111111111111111111111111111111111111
1111111111111111111111111111111111111111111111111111111111111111111111111111111111111111111111111111
1111111111111111111111111111111111111111111111111111111111111111111111111111111111111111111111111111
1111111111111111111111111111111111111111111111111111111111111111111111111111111111111111111111111111
1111111111111111111111111111111111111111111111111111111111111111111111111111111111111111111111111111
1111111111111111111111111111111111111111111111111111111111111111111111111111111111111111111111111111
1111111111111111111111111111111111111111111111111111111111111111111111111111111111111111111111111111
1111111111111111111111111111111111111111111111111111111111111111111111111111111111111111111111111111
1111111111111111111111111111111111111111111111111111111111111111111111111111111111111111111111111111
1111111111111111111111111111111111111111111111111111111111111111111111111111111111111111111111111111
1111111111111111111111111111111111111111111111111111111111111111111111111111111111111111111111111111
1111111111111111111111111111111111111111111111111111111111111111111111111111111111111111111111111111
1111111111111111111111111111111111111111111111111111111111111111111111111111111111111111111111111111
1111111111111111111111111111111111111111111111111111111111111111111111111111111111111111111111111111
1111111111111111111111111111111111111111111111111111111111111111111111111111111111111111111111111111
1111111111111111111111111111111111111111111111111111111111111111111111111111111111111111111111111111
1111111111111111111111111111111111111111111111111111111111111111111111111111111111111111111111111111
1111111111111111111111111111111111111111111111000000111111111111111111111111111111111111111111111111
1111111111111111111111111111111111111111111111000000111111111111111111111111111111111111111111111111
1111111111111111111111111111111111111111111111000000111111111111111111111111111111111111111111111111
1111111111111111111111111111111111111111111111000000111111111111111111111111111111111111111111111111
1111111111111111111111111111111111111111000000000000000000111111111111111111111111111111111111111111
1111111111111111111111111111111111111111000000000000000000111111111111111111111111111111111111111111
1111111111111111111111111111111111111111000000000000000000111111111111111111111111111111111111111111
1111111111111111111111111111111111111111000000000000000000111111111111111111111111111111111111111111
1111111111111111111111111111111111111111111111000000111111111111111111111111111111111111111111111111
1111111111111111111111111111111111111111000000000000000000111111111111111111111111111111111111111111
1111111111111111111111111111111111111111000000000000000000111111111111111111111111111111111111111111
1111111111111111111111111111111111111111000000000000000000111111111111111111111111111111111111111111
1111111111111111111111111111111111111111111111000000111111111111111111111111111111111111111111111111
1111111111111111111111111111111111111111000000000000000000111111111111111111111111111111111111111111
1111111111111111111111111111111111111111000000000000000000111111111111111111111111111111111111111111
1111111111111111111111111111111111111111000000000000000000111111111111111111111111111111111111111111
1111111111111111111111111111111111111111111111000000111111111111111111111111111111111111111111111111
1111111111111111111111111111111111111111000000000000000000111111111111111111111111111111111111111111
1111111111111111111111111111111111111111000000000000000000111111111111111111111111111111111111111111
1111111111111111111111111111111111111111000000000000000000111111111111111111111111111111111111111111
1111111111111111111111111111111111111111111111000000111111111111111111111111111111111111111111111111
1111111111111111111111111111111111111111111111000000111111111111111111111111111111111111111111111111
1111111111111111111111111111111111111111111111000000111111111111111111111111111111111111111111111111
1111111111111111111111111111111111111111111111000000111111111111111111111111111111111111111111111111
1111111111111111111111111111111111111111111111111111111111111111111111111111111111111111111111111111
1111111111111111111111111111111111111111111111111111111111111111111111111111111111111111111111111111
1111111111111111111111111111111111111111111111111111111111111111111111111111111111111111111111111111
1111111111111111111111111111111111111111111111111111111111111111111111111111111111111111111111111111
1111111111111111111111111111111111111111111111111111111111111111111111111111111111111111111111111111
1111111111111111111111111111111111111111111111111111111111111111111111111111111111111111111111111111
1111111111111111111111111111111111111111111111111111111111111111111111111111111111111111111111111111
1111111111111111111111111111111111111111111111111111111111111111111111111111111111111111111111111111
1111111111111111111111111111111111111111111111111111111111111111111111111111111111111111111111111111
1111111111111111111111111111111111111111111111111111111111111111111111111111111111111111111111111111
1111111111111111111111111111111111111111111111111111111111111111111111111111111111111111111111111111
1111111111111111111111111111111111111111111111111111111111111111111111111111111111111111111111111111
1111111111111111111111111111111111111111111111111111111111111111111111111111111111111111111111111111
1111111111111111111111111111111111111111111111111111111111111111111111111111111111111111111111111111
1111111111111111111111111111111111111111111111111111111111111111111111111111111111111111111111111111
1111111111111111111111111111111111111111111111111111111111111111111111111111111111111111111111111111
1111111111111111111111111111111111111111111111111111111111111111111111111111111111111111111111111111
1111111111111111111111111111111111111111111111111111111111111111111111111111111111111111111111111111
1111111111111111111111111111111111111111111111111111111111111111111111111111111111111111111111111111
1111111111111111111111111111111111111111111111111111111111111111111111111111111111111111111111111111
1111111111111111111111111111111111111111111111111111111111111111111111111111111111111111111111111111
1111111111111111111111111111111111111111111111111111111111111111111111111111111111111111111111111111
1111111111111111111111111111111111111111111111111111111111111111111111111111111111111111111111111111
1111111111111111111111111111111111111111111111111111111111111111111111111111111111111111111111111111
1111111111111111111111111111111111111111111111111111111111111111111111111111111111111111111111111111
1111111111111111111111111111111111111111111111111111111111111111111111111111111111111111111111111111
1111111111111111111111111111111111111111111111111111111111111111111111111111111111111111111111111111
1111111111111111111111111111111111111111111111111111111111111111111111111111111111111111111111111111
1111111111111111111111111111111111110000001111111100000011111111111111111111111111111111111111111111
1111111111111111111111111111111111110000001111111100000011111111111111111111111111111111111111111111
1111111111111111111111111111111111110000001111111100000011111111111111111111111111111111111111111111
1111111111111111111111111111111111110000001111111100000011111111111111111111111111111111111111111111
1111111111111111111111111111111111110000000000000000000000000001111111111111111111111111111111111111
1111111111111111111111111111111111110000000000000000000000000001111111111111111111111111111111111111
1111111111111111111111111111111111110000000000000000000000000001111111111111111111111111111111111111
1111111111111111111111111111111111110000000000000000000000000001111111111111111111111111111111111111
1111111111111111111111111111111111000000111111000000000011111100001111111111111111111111111111111111
1111111111111111111111111111111111000000000000011000000000000000001111111111111111111111111111111111
1111111111111111111111111111111111000010000000011000000000000000111111111111111111111111111111111111
1111111111111111111111111111111111000010000000000000100000000000111111111111111111111111111111111111
1111111111111111111111111111111111000010000000000100100000000000111111111111111111111111111111111111
1111111111111111111111111111111111000010000110000100100001110000111111111111111111111111111111111111
1111111111111111111111111111111111000010000110000100100001110000111111111111111111111111111111111111
1111111111111111111111111111111111000010000000000100100000000000111111111111111111111111111111111111
1111111111111111111111111111111111000000000000000100100000000000111111111111111111111111111111111111
1111111111111111111111111111111111000001100000000100000000000000111111111111111111111111111111111111
1111111111111111111111111111111111000001100000000000000000000000001111111111111111111111111111111111
1111111111111111111111111111111111000000001111110000000011111100001111111111111111111111111111111111
1111111111111111111111111111111111110000000000000000000000000001111111111111111111111111111111111111
1111111111111111111111111111111111110000000000000000000000000001111111111111111111111111111111111111
1111111111111111111111111111111111110000000000000000000000000001111111111111111111111111111111111111
1111111111111111111111111111111111110000000000000000000000000001111111111111111111111111111111111111
1111111111111111111111111111111111111111111111000000001111111111111111111111111111111111111111111111
1111111111111111111111111111111111111111111111000000001111111111111111111111111111111111111111111111
1111111111111111111111111111111111111111111111000000001111111111111111111111111111111111111111111111
1111111111111111111111111111111111111111111111000000001111111111111111111111111111111111111111111111
1111111111111111111111111111111111111111111111000000001111111111111111111111111111111111111111111111
1111111111111111111111111111111111111111111111000000001111111111111111111111111111111111111111111111
1111111111111111111111111111111111111111111111111111111111111111111111111111111111111111111111111111
1111111111111111111111111111111111111111111111111111111111111111111111111111111111111111111111111111
1111111111111111111111111111111111111111111111111111111111111111111111111111111111111111111111111111
1111111111111111111111111111111111111111111111111111111111111111111111111111111111111111111111111111
1111111111111111111111111111111111111111111111111111111111111111111111111111111111111111111111111111
1111111111111111111111111111111111111111111111111111111111111111111111111111111111111111111111111111
