0000000000000000000000000000000000000000000000000000000000000000000000000000000000000000000000000000
1111111111111111111111111111111111111111111111111111111111111111111111111111111111111111111111111110
1111111111111111111111111111111111111111111111111111111111111111111111111111111111111111111111111110
1111111111111111111111111111111111111111111111111111111111111111111111111111111111111111111111111110
1111111111111111111111111111111111111111111111111111111111111111111111111111111111111111111111111110
1111111111111111111111111111111111111111111111111111111111111111111111111111111111111111111111111110
1111111111111111111111111111111111111111111111111111111111111111111111111111111111111111111111111110
1111111111111111111111111111111111111111111111111111111111111111111111111111111111111111111111111110
1111111111111111111111111111111111111111111111111111111111111111111111111111111111111111111111111110
1111111111111111111111111111111111111111111111111111111111111111111111111111111111111111111111111110
1111111111111111111111111111111111111111111111111111111111111111111111111111111111111111111111111110
1111111111111111111111111111111111111111111111111111111111111111111111111111111111111111111111111110
1111111111111111111111111111111111111111111111111111111111111111111111111111111111111111111111111110
1111111111111111111111111111111111111111111111111111111111111111111111111111111111111111111111111110
1111111111111100000000000000000011111111110000000000000000001111111111111111111111111111111111111110
1111111111111100000000000000000011111111110000000000000000001111111111111111111111111111111111111110
1111111111111100000000000000000000111111000000000000000000001111111111111111111111111111111111111110
1111111111111100000000000000000000111111000000000000000000001111111111111111111111111111111111111110
1111111111111100000000000000000000111111000000000000000000001111111111111111111111111111111111111110
1111111111111100000000000000000000111111000000000000000000001111111111111111111111111111111111111110
1111111111111100000000000000000000111111000000000000000000001111111111111111111111111111111111111110
1111111111111100000000000000010000111111000000000000000000001111111111111111111111111111111111111110
1111111111111100000000000000000000111111000000000000000000001111111111111111111111111111111111111110
1111111111111100000000000000000000111111000000000000000000001111111111111111111111111111111111111110
1111111111111100000000000000000000111111000000000000000001001111111111111111111111111111111111111110
1111111111111100000000000000000000111111000000000000000000001111111111111111111111111111111111111110
1111111111111100000000000000000000111111000000000000000000001111111111111111111111111111111111111110
1111111111111100000000000000000000111111000000000000000000001111111111111111111111111111111111111110
1111111111111100000000000000000000111111000000000000000000001111111111111111111111111111111111111110
1111111111111100000000000000000000111111000000000000000000001111111111111111111111111111111111111110
1111111111111100000000000000000000111111000000000000000000001111111111111111111111111111111111111110
1111111111111100000000000000000000111111000000000000000000001111111111111111111111111111111111111110
1111111111111100000000000000000000111111000000000000000000001111111111111111111111111111111111111110
1111111111111100000000000000000000111111000000000000000000001111111111111111111111111111111111111110
1111111111111111000000000000000011111111110000000000000000111111111111111111111111111111111111111110
1111111111111111555555555555555511111111115555555555555555111111111155555555555555551111111111111110
1111111111111101000000000000000010001000010000000000000000100000000100000000000000001011111111111110
1111111111111100000000000000000000001000000000000000000000000000000000000000000000000011111111111110
1111111111111100000110000000000000001000000000000001100000000000000000000001100000000011111111111110
1111111111111100000011100000000000001000000000000001110000000000000000000001100000000011111111111110
1111111111111100000001100000000000000000000000000001111000000000000000000001110000000011111111111110
1111111111111100000001100000000000000000000000000000010000000000000000000001110000000011111111111110
1111111111111100000001100000000000000000000000000000000000000000000000000011100000000011111111111110
1111111111111100000000000000000000000000000000000000000000000000000000000000000000000011111111111110
1111111111111111000000000000000000001000000000000000000000000000000000000000000000000011111111111110
1111111111111111000000000000000000001000000000000000000000000000000000000000000000000011111111111110
1111111111111111110000000000000000001000000000000000000000000000000000000000000000000011111111111110
1111111111111111110000000000011111111000000000000000000000000000000000000000000000000011111111111110
1111111111111111000000000001110000111111111111111111111111111111111111111111111111111111111111111110
1111111111111111000000000001110000111111111111111111111111111111111111111111111111111111111111111110
1111111111111111110000000011110000111111111111111111111111111111111111111111111111111111111111111110
1111111111111111110000000111110000111111111111111111111111111111111111111111111111111111111111111110
1111111111111111000000000100000000111111005005001111005005001111005005001111115005111111111111111110
1111111111111111000000000100000000111111005005001111005005001111005005001111115005111111111111111110
1111111111111111110000000100000000111111005005001111005005001111005005001111115005111111111111111110
1111111111111111110000000100000000111111555005551111555005551111555005551111115005111111111111111110
1111111111111111000000000100001111111111555005551111555005551111555005551111115005111111111111111110
1111111111111111000000000100001000111111005005001111005005001111005005001111115005111111111111111110
1111111111111100110000000000000000111111005005001111005005001111005005001111115005111111111111111110
1111111111111100110000000000000000111111005005001111005005001111005005001111115005111111111111111110
1111111111111100000000000000000000111111555005551111555005551111555005551111555005551111111111111110
1111111111111100000000000000000000111111555005551111555005551111555005551111555005551111111111111110
1111111111111111110000000000000001111001000000001001000000001001000000001001000000001011111111111110
1111111111111111110000000000000000111000000000000000000000000000000000000000000000000011111111111110
1111111111111100000000000000000000001000000000000000000000000000000000000000000000000011111111111110
1111111111111100000000000000000000001000000000000000000000000000000000000000000000000011111111111110
1111111111111100000000000000000000000000000000000000000000000000000000000000000000000011111111111110
1111111111111100000000000000000000000000000000000000000000000000000000000000000000000011111111111110
1111111111111100000000000000000000000000000000000000000000000000000000000000000000000011111111111110
1111111111111100000000000000000000000000000000000000000000000000000000000000000000000011111111111110
1111111111111100000000000000000000000000000000000000000000000000000000000000000000000011111111111110
1111111111111100000000000000000000000000000000000000000000000000000000000000000000000011111111111110
1111111111111100000000000000000000001000000000000000000000000000000000000000000000000011111111111110
1111111111111100000000000000000000001000000000000000000000000000000000000000000000000011111111111110
1111111111111100000000000000000000001000000000000000000000000000000000000000000000000011111111111110
1111111111111100000000000001000000011001000000001001000000001001000000001001000000001011111111111110
1111111111111110000000011111555005551111555005551111555005551111555005551111555005551111111111111110
1111111111111100000000001111555005551111555005551111555005551111555005551111555005551111111111111110
1111111111111100000000001111005005001111005005001111005005001111005005001111115005111111111111111110
1111111111111100000000001111005005001111005005001111005005001111005005001111115005111111111111111110
1111111111111101000000101111005005001111005005001111005005001111005005001111115005111111111111111110
1111111111111101000000101111555005551111555005551111555005551111555005551111115005111111111111111110
1111111111111101000000101111555005551111555005551111555005551111555005551111115005111111111111111110
1111111111111101000000101111005005001111005005001111005005001111005005001111115005111111111111111110
1111111111111101000000101111005005001111005005001111005005001111005005001111115005111111111111111110
1111111111111101000000101111005005001111005005001111005005001111005005001111115005111111111111111110
1111111111111111111111111111111111111111111111111111111111111111111111111111111111111111111111111110
1111111111111111111111111111111111111111111111111111111111111111111111111111111111111111111111111110
1111111111111111111111111111111111111111111111111111111111111111111111111111111111111111111111111110
1111111111111111111111111111111111111111111111111111111111111111111111111111111111111111111111111110
1111111111111111111111111111111111111111111111111111111111111111111111111111111111111111111111111110
1111111111111111111111111111111111111111111111111111111111111111111111111111111111111111111111111110
1111111111111111111111111111111111111111111111111111111111111111111111111111111111111111111111111110
1111111111111111111111111111111111111111111111111111111111111111111111111111111111111111111111111110
1111111111111111111111111111111111111111111111111111111111111111111111111111111111111111111111111110
1111111111111111111111111111111111111111111111111111111111111111111111111111111111111111111111111110
1111111111111111111111111111111111111111111111111111111111111111111111111111111111111111111111111110
1111111111111111111111111111111111111111111111111111111111111111111111111111111111111111111111111110
1111111111111111111111111111111111111111111111111111111111111111111111111111111111111111111111111110
1111111111111111111111111111111111111111111111111111111111111111111111111111111111111111111111111110
