11111111111111111111111111111111111111111111111111111111111111111111111111111111111111111111111111111111111111111111111111111111111111111111
11111111111111111111111111111111111111111111111111111111111111111111111111111111111111111111111111111111111111111111111111111111111111111110
11111111111111111111111111111111111111111111111111111111111111111111111111111111111111111111111111111111111111111111111111111111111111111110
11111111111111111111111111111111111111111111111111111111111111111111111111111111111111111111111111111111111111111111111111111111111111111110
11111111111111111111111111111111111111111111111111111111111111111111111111111111111111111111111111111111111111111111111111111111111111111110
11111111111111111111111111111111111111111111111111111111111111111111111111111111111111111111111111111111111111111111111111111111111111111110
11111111111111111111111111111111111111111111111111111111111111111111111111111111111111111111111111111111111111111111111111111111111111111110
11111111111111111111111111111111111111111111111111111111111111111111111111111111111111111111111111111111111111111111111111111111111111111110
11111111111111111111111111111111111111111111111111111111111111111111111111111111111111111111111111111111111111111111111111111111111111111110
11111111111111111111111111111111111111111111111111111111111111111111111111111111111111111111111111111111111111111111111111111111111111111110
11111111111111111111111111111111111111111111111111111111111111111111111111111111111111111111111111111111111111111111111111111111111111111110
11111111111111111111111111111111111111111111111111111111111111111111111111111111111111111111111111111111111111111111111111111111111111111110
11111111111111111111111111111111111111111111111111111111111111111111111111111111111111111111111111111111111111111111111111111111111111111110
11111111111111111111111111111111111111000000000000000000000000001111111111110000000000001100000000000011111111111111111111111111111111111110
11111111111111111111111111111111110000000000000000000000000000000011111111000000000000001100000000000000001111111111111111111111111111111110
11111111111111111111111111111111110000000000000000000000000000000011111111000000000000001100000000000000001111111111111111111111111111111110
11111111111111111111111111111111000000000000000000000000000000000000111100000000000000000000000000000000000011111111111111111111111111111110
11111111111111111111111111111111000000000000000000000000000000000000111100000000000000000000000000000000000011111111111111111111111111111110
11111111111111111111111111111100000000000000000000000000000000000000111100000000000000000000000000000000000000111111111111111111111111111110
11111111111111111111111111111100000000000000000000000000000000000000111100000000000000000000000000000000000000111111111111111111111111111110
11111111111111111111111111110000000000110000000000001100000000000011111100000000000000000000000000000000000000001111111111111111111111111110
11111111111111111111111111110000000000110000000000001100000000000011111100000000000000000000000000000000000000001111111111111111111111111110
11111111111111111111111111110000000000000000000000000000000000000000111100000000000000000000000000000000000000001111111111111111111111111110
11111111111111111111111111110000000000000000000000000000000000000111111101100000000001100000000000011000000000001111111111111111111111111110
11111111111111111111111111000000000000000000000000000000000000000111111101100000000001100000000000011000000000000011111111111111111111111110
11111111111111111111111111000000000000000000000000000000000000000111111100000000000000000000000000000000000000000011111111111111111111111110
11111111111111111111111111000000000000000000000000000000000000000111111100000000000000000000000000000000000000000011111111111111111111111110
11111111111111111111111111000000000000000000000000000000000000000111111100000000000000000000000000000000000000000011111111111111111111111110
11111111111111111111111111100000000000000000000000000000000000000111111100000000000000000000000000000000000000000011111111111111111111111110
11111111111111111111111111100000000000000000000000000000000000000111111100000000000000000000000000000000000000000111111111111111111111111110
11111111111111111111111111100000000000000000000000000000000000000111111100000000000000000000000000000000000000000111111111111111111111111110
11111111111111111111111100000000000000000000000000000000000000000111111100000000000000000000000000000000000000000000111111111111111111111110
11111111111111111111111100000000000000000000000000000000000000000111111100000000000000000000000000000000000000000000111111111111111111111110
11111111111111111111111100000000000000000000000000000000000000000111111100000000000000000000000000000000000000000000111111111111111111111110
11111111111111111111111100000000000000000000000000000000000000000111111100000000000000000000000000000000000000000000111111111111111111111110
11111111111111111111111100000000000000000000000000000000000000000000111100000000000000000000000000000000000000000000111111111111111111111110
11111111111111111111111100000000000000110000000000001100000000000011111100000000000000000000000000000000000000000000111111111111111111111110
11111111111111111111111111100000000000110000000000001100000000000011111100000000000000000000000000000000000000000111111111111111111111111110
11111111111111111111111111100000000000000000000000000000000000000000111100000000000000000000000000000000000000000111111111111111111111111110
11111111111111111111111111100000000000000000000000000000000000000000111100000000000000000000000000000000000000000011111111111111111111111110
11111111111111111111111111000000000000000000000000000000000000000000111100000000000000000000000000000000000000000011111111111111111111111110
11111111111111111111111111000000000000000000000000000000000000000000111101100000000001100000000000011000000000000011111111111111111111111110
11111111111111111111111111111111111111111111111111111111000000001111111101100000000001100000000000011000000000000011111111111111111111111110
11111111111111111111111111111111111111111111111111111111000000001111111100000000000000000000000000000000000000000011111111111111111111111110
11111111111111111111111111000000000000000000000000110000000000000000111100000000000000000000000000000000000000000011111111111111111111111110
11111111111111111111111111000000000000000000000000110000000000000000111100000000000000000000000000000000000000000011111111111111111111111110
11111111111111111111111111000000000000000000000000110000000000000000111100000000000000000000000000000000000000000011111111111111111111111110
11111111111111111111111111000000000000000000000000110000000000000000111100000000000000000000000000000000000000000011111111111111111111111110
11111111111111111111111111000000000000000000000000110000000000000000111100000000000000001100000000000000000000000011111111111111111111111110
11111111111111111111111111000000000000000000000000110000000000000000111100000000000000001100000000000000000000000011111111111111111111111110
11111111111111111111111111000000000000000000000000110000000000000000111100000000000000001100000000000000000000000011111111111111111111111110
11111111111111111111111111000000000000000000000000110000000000000000111100000000000000001100000000000000000000000011111111111111111111111110
11111111111111111111111111000000000000000000000000110000000000000000111100000000000000001111111111111111111111111111111111111111111111111110
11111111111111111111111111000000000000000000000000110000000000000000111100000000000000001111111111111111111111111111111111111111111111111110
11111111111111111111111111000000000000000000000000110000000000000000111100000000000000001111000000011111100000001111111111111111111111111110
11111111111111111111111111100000000000000000000001110000000000000000111100000000000000001111000000011111100000001111111111111111111111111110
11111111111111111111111111100000000000000000000001110000000000000000111100000000000000001100000000000000000000000111111111111111111111111110
11111111111111111111111111100000000000000000000001110000000000000000111100000000000000001100000000000000000000000111111111111111111111111110
11111111111111111111111111100000000000000000000001110000000000000000111100000000000000001100000000000000000000000111111111111111111111111110
11111111111111111111111111100000000000000000000001110000000000000000111101100000000001101100000000000000000000000111111111111111111111111110
11111111111111111111111111100000000000000000000001110000000000000000111101100000000001101100000000000000000000000111111111111111111111111110
11111111111111111111111111100000000000000000000001110000000000000000111100000000000000001100000000000000000000000111111111111111111111111110
11111111111111111111111111100000000000000000000001110000000000000000111100000000000000001100000000000000000000000111111111111111111111111110
11111111111111111111111111100000000000000000000001110000000000000000111100000000000000001100000000000000000000000111111111111111111111111110
11111111111111111111111111100000000000000000000001110000000000000000111100000000000000001100000000000000000000000111111111111111111111111110
11111111111111111111111111100000000000000000000001110000000000000000111100000000000000001100000000000000000000000111111111111111111111111110
11111111111111111111111111100000000000000000000001110000000000000000111100000000000000001100000000000000000000000111111111111111111111111110
11111111111111111111111111100000000000000000000001110000000000000000111100000000000000001100000000000000000000000111111111111111111111111110
11111111111111111111111111100000000000000000000001110000000000000000111100000000000000001100000000000000000000000111111111111111111111111110
11111111111111111111111111000000000000000000000000110000000000000000111100000000000000001100000000000000000000000011111111111111111111111110
11111111111111111111111111000000000000000000001111111111111100000011111111000000111111111111110000000000000000001111111111111111111111111110
11111111111111111111111111000000000000000000001111111111111100000011111111000000111111111111110000000000000000001111111111111111111111111110
11111111111111111111111111000000000000000000001111111111111100000011111111000000111111111111110000000000000000000011111111111111111111111110
11111111111111111111111111000000000000000000001111111111111100000011111111000000111111111111110000000000000000000011111111111111111111111110
11111111111111111111111111100000000000000000001111111111000000000000111100000000000011111111110000000000000000000111111111111111111111111110
11111111111111111111111111100000000000000000001111111111000000000000111100000000000011111111110000000000000000000111111111111111111111111110
11111111111111111111111111100000000000000000001111111100000000000000111100000000000000111111110000000000000000000111111111111111111111111110
11111111111111111111111111100000000000000000001111111100000000000000111100000000000000111111110000000000000000000111111111111111111111111110
11111111111111111111111111100000000000000000001111110000000000000000111100000000000000001111110000000000000000000111111111111111111111111110
11111111111111111111111111100000000000000000001111110000000000000000111100000000000000001111110000000000000000000111111111111111111111111110
11111111111111111111111111100000000000000000001111000000000000000000111100000000000000000011110000000000000000000111111111111111111111111110
11111111111111111111111111100000000000000000001111000000000000000000111100000000000000000011110000000000000000000111111111111111111111111110
11111111111111111111111111100000000000000000001111000000000000000000111100000000000000000011110000000000000000000111111111111111111111111110
11111111111111111111111111100000000000000000001111000000000000000000111100000000000000000011110000000000000000000111111111111111111111111110
11111111111111111111111111100000000000000000000000000000000000000000111100000000000000000000000000000000000000000111111111111111111111111110
11111111111111111111111111100000000000000000000000000000000000000000111100000000000000000000000000000000000000000111111111111111111111111110
11111111111111111111111111000000000000000000000000000000000000000000111100000000000000000000000000000000000000000011111111111111111111111110
11111111111111111111111111000000000000000000000000000000000000000000111100000000000000000000000000000000000000000011111111111111111111111110
11111111111111111111111111110000000000000000000000000000000000000000111100000000000000000000000000000000000000001111111111111111111111111110
11111111111111111111111111110000000000000000000000000000000000000000111100000000000000000000000000000000000000001111111111111111111111111110
11111111111111111111111111111100000000000000001111000000000000000011111111000000000000000011110000000000000000111111111111111111111111111110
11111111111111111111111111111100000000000000001111000000000000000011111111000000000000000011110000000000000000111111111111111111111111111110
11111111111111111111111111111111110000001111111111111111111111111111111111111111111111111111111111110000001111111111111111111111111111111110
11111111111111111111111111111111110000001111111111111111111111111111111111111111111111111111111111110000001111111111111111111111111111111110
11111111111111111111111111111111110000001111111111111111111111111111111111111111111111111111111111110000001111111111111111111111111111111110
11111111111111111111111111111111110000001111111111111111111111111111111111111111111111111111111111110000001111111111111111111111111111111110
11111111111111111111111111111100000000000000001111000000000000000011111111000000000000000011110000000000000000111111111111111111111111111110
11111111111111111111111111111100000000000000001111000000000000000011111111000000000000000011110000000000000000111111111111111111111111111110
11111111111111111111111111110000000000000000000000000000000000000000111100000000000000000000000000000000000000001111111111111111111111111110
11111111111111111111111111110000000000000000000000000000000000000000111100000000000000000000000000000000000000001111111111111111111111111110
11111111111111111111111111000000000000000000000000000000000000000000111100000000000000000000000000000000000000000011111111111111111111111110
11111111111111111111111111000000000000000000000000000000000000000000111100000000000000000000000000000000000000000011111111111111111111111110
11111111111111111111111111100000000000000000000000000000000000000000111100000000000000000000000000000000000000000111111111111111111111111110
11111111111111111111111111100000000000000000000000000000000000000000111100000000000000000000000000000000000000000111111111111111111111111110
11111111111111111111111111100000000000000000001111000000000000000000111100000000000000000011110000000000000000000111111111111111111111111110
11111111111111111111111111100000000000000000001111000000000000000000111100000000000000000011110000000000000000000111111111111111111111111110
11111111111111111111111111100000000000000000001111000000000000000000111100000000000000000011110000000000000000000111111111111111111111111110
11111111111111111111111111100000000000000000001111000000000000000000111100000000000000000011110000000000000000000111111111111111111111111110
11111111111111111111111111100000000000000000001111110000000000000000111100000000000000001111110000000000000000000111111111111111111111111110
11111111111111111111111111100000000000000000001111110000000000000000111100000000000000001111110000000000000000000111111111111111111111111110
11111111111111111111111111100000000000000000001111111100000000000000111100000000000000111111110000000000000000000111111111111111111111111110
11111111111111111111111111100000000000000000001111111100000000000000111100000000000000111111110000000000000000000111111111111111111111111110
11111111111111111111111111100000000000000000001111111111000000000000111100000000000011111111110000000000000000110111111111111111111111111110
11111111111111111111111111100000000000000000001111111111000000000000111100000000000011111111110000000000000000110111111111111111111111111110
11111111111111111111111111100000000000000000001111111111111100000011111111000000111111111111110000000000000000011111111111111111111111111110
11111111111111111111111111000000000000000000001111111111111100000011111111000000111111111111110000000000000000011111111111111111111111111110
11111111111111111111111111000000000000000000001111111111111100000011111111000000111111111111110000000000000000011111111111111111111111111110
11111111111111111111111111000000000000000000001111111111111111111111111111000000111111111111110000000000000000011111111111111111111111111110
11111111111111111111111111000000000000000000000011000000000000000000111100000000111111100011000000000000000000011111111111111111111111111110
11111111111111111111111111000000000000000000000011000000000000000000111100000000000000000011000000000000000000011111111111111111111111111110
11111111111111111111111111100000000000000000000011000000000000000000111100000000000000000011000000000000000000011111111111111111111111111110
11111111111111111111111111100000000000000000000011000000000000000000111110000000000000000011100000000000000000011111111111111111111111111110
11111111111111111111111111100000000000000000000011000000000000000000111110000000000000000011100000000000000000011111111111111111111111111110
11111111111111111111111111100000000000000000000011000000000000000001111110000000000000000011100000000000000000011111111111111111111111111110
11111111111111111111111111100000000000000000000011000000000000000001111110000000000000000011100000000000000000011111111111111111111111111110
11111111111111111111111111100000000000000000000011000000000000000001111110000000000000000011100000000000000000011111111111111111111111111110
11111111111111111111111111100000000000000000000011000000000000000001111110000000000000000011100000000000000000110111111111111111111111111110
11111111111111111111111111100000000000000000000011000000000000000001111110000000000000000011100000000000000000110111111111111111111111111110
11111111111111111111111111100000000000000000000011000000000000000001111110000000000000000011100000000000000000000111111111111111111111111110
11111111111111111111111111100000000000000000000011000000000000000001111110000000000000000011100000000000000000000111111111111111111111111110
11111111111111111111111111100000000000000000000011000000000000000001111110000000000000000011100000000000000000000111111111111111111111111110
11111111111111111111111111100000000000000000000011000000000000000001111110000000000000000011100000000000000000000111111111111111111111111110
11111111111111111111111111100000000000000000000000000000000000000001111110000000000000000011100000000000000000000111111111111111111111111110
11111111111111111111111111000000000000000000000000000000000000000001111110000000000000000011100000000000000000000111111111111111111111111110
11111111111111111111111111000000000000000000000000000000000000000001111110000000000000000011100000000000000000000111111111111111111111111110
11111111111111111111111111000000000000000000000000000000000000000001111100000000000000000011000000000000000000000111111111111111111111111110
11111111111111111111111111000000000000000000000000000000000000000001111100000000000000000011000000000000000000000111111111111111111111111110
11111111111111111111111111000000000000000000000000000000000000000000111100000000000000000011000000000000000000000111111111111111111111111110
11111111111111111111111111000000000000000000000011000000000000000000111100000000000000000000000000000000000000000111111111111111111111111110
11111111111111111111111111000000000000000000000011000000000000000000111100000000000000000000000000000000000000000011111111111111111111111110
11111111111111111111111111000000000000000000000011000000000000000000111100000000000000000000000000000000000000000011111111111111111111111110
11111111111111111111111111000000000000000000000011000000000000000000111100000000000000000000000000000000000000000011111111111111111111111110
11111111111111111111111111000000000000000000000011000000000000000000111100000000000000000000000000000000000000000011111111111111111111111110
11111111111111111111111111000000000000000000000011000000000000000001111100000000000000000000000000000000000000000011111111111111111111111110
11111111111111111111111111111111111111111111111111000000000000000001111100000000000000000011000000000000000000000011111111111111111111111110
11111111111111111111111111111111111111111111111111000000000000000001111100000000000000000011000000000000000000000011111111111111111111111110
11111111111111111111111111000000000000000000000011000000000000000001111100000000000000000011000000000000000000000011111111111111111111111110
11111111111111111111111111000000000000000000000011000000000000000001111100000000000000000011000000000000000000000011111111111111111111111110
11111111111111111111111111000000000000000000000011000000000000000001111111111100000011111111111111111111111111111111111111111111111111111110
11111111111111111111111111000000000000000000000011000000000000000001111111111100000011111111111111111111111111111111111111111111111111111110
11111111111111111111111111000000000000000000000011000000000000000001111100000000000000000001100000000001100000000011111111111111111111111110
11111111111111111111111111100000000000000000000011000000000000000001111100000000000000000001100000000001100000000111111111111111111111111110
11111111111111111111111111100000000000000000000000000000000000000001111100000000000000000000000000000000000000000111111111111111111111111110
11111111111111111111111111100000000000000000000000000000000000000001111100000000000000000000000000000000000000000111111111111111111111111110
11111111111111111111111111100000000000000000000000000000000000000001111100000000000000000000000000000000000000000111111111111111111111111110
11111111111111111111111111100000000000000000000000000000000000000001111100000000000000000000000000000000000000000111111111111111111111111110
11111111111111111111111111100000000000000000000000000000000000000001111100000000000000000000000000000000000000000111111111111111111111111110
11111111111111111111111111100000000000000000000000000000000000000000111100000000000000000000000000000000000000000111111111111111111111111110
11111111111111111111111111100000000000000000000011000000000000000000111100000000000000000000000000000000000000000111111111111111111111111110
11111111111111111111111111100000000000000000000011000000000000000000111100000000000000000000000000000000000000000111111111111111111111111110
11111111111111111111111111100000000000000000000011000000000000000000111100000000000000000000000000000000000000000111111111111111111111111110
11111111111111111111111111100000000000000000000011000000000000000000111100000000000000000000000000000000000000000111111111111111111111111110
11111111111111111111111111100000000000000000000011111111111111111111111100000000000000000000000000000000000000000111111111111111111111111110
11111111111111111111111111100000000000000000000011111111111111111111111100000000000000000000000000000000000000000111111111111111111111111110
11111111111111111111111111100000000000000000000011000000000000000000000000000000000000000000000000000000000000000111111111111111111111111110
11111111111111111111111111000000000000000000000011000000000000000000000000000000000000000000000000000000000000000011111111111111111111111110
11111111111111111111111111110000000000000000000011000000000000000000000000000000000000000000000000000000000000001111111111111111111111111110
11111111111111111111111111110000000000000000000011000000000000000000000000000000000000000000000000000000000000001111111111111111111111111110
11111111111111111111111111110000000000000000000000000000000000000000000000000000000000000000000000000000000000001111111111111111111111111110
11111111111111111111111111110000000000000000000000000000000000000000000000000000000000000000000000000000000000001111111111111111111111111110
11111111111111111111111111111100000000000000000000000000000000000000111100000000000000000000000000000000000000111111111111111111111111111110
11111111111111111111111111111100000000000000000000000000000000000000111100000000000000000000000000000000000000111111111111111111111111111110
11111111111111111111111111111111000000000000000000000000000000000000111100000000000000000000000000000000000011111111111111111111111111111110
11111111111111111111111111111111000000000000000000000000000000000000111100000000000000000000000000000000000011111111111111111111111111111110
11111111111111111111111111111111110000000000000000110000000000000011111111000000000000000000000000000000001111111111111111111111111111111110
11111111111111111111111111111111110000000000000000110000000000000011111111000000000000000000000000000000001111111111111111111111111111111110
11111111111111111111111111111111111111000000000000110000000000001111111111110000000000000000000000000011111111111111111111111111111111111110
11111111111111111111111111111111111111111111111111111111111111111111111111111111111111111111111111111111111111111111111111111111111111111110
11111111111111111111111111111111111111111111111111111111111111111111111111111111111111111111111111111111111111111111111111111111111111111110
11111111111111111111111111111111111111111111111111111111111111111111111111111111111111111111111111111111111111111111111111111111111111111110
11111111111111111111111111111111111111111111111111111111111111111111111111111111111111111111111111111111111111111111111111111111111111111110
11111111111111111111111111111111111111111111111111111111111111111111111111111111111111111111111111111111111111111111111111111111111111111110
11111111111111111111111111111111111111111111111111111111111111111111111111111111111111111111111111111111111111111111111111111111111111111110
11111111111111111111111111111111111111111111111111111111111111111111111111111111111111111111111111111111111111111111111111111111111111111110
11111111111111111111111111111111111111111111111111111111111111111111111111111111111111111111111111111111111111111111111111111111111111111110
11111111111111111111111111111111111111111111111111111111111111111111111111111111111111111111111111111111111111111111111111111111111111111110
11111111111111111111111111111111111111111111111111111111111111111111111111111111111111111111111111111111111111111111111111111111111111111110
11111111111111111111111111111111111111111111111111111111111111111111111111111111111111111111111111111111111111111111111111111111111111111110
11111111111111111111111111111111111111111111111111111111111111111111111111111111111111111111111111111111111111111111111111111111111111111110
11111111111111111111111111111111111111111111111111111111111111111111111111111111111111111111111111111111111111111111111111111111111111111110
11111111111111111111111111111111111111111111111111111111111111111111111111111111111111111111111111111111111111111111111111111111111111111110
11111111111111111111111111111111111111111111111111111111111111111111111111111111111111111111111111111111111111111111111111111111111111111110
11111111111111111111111111111111111111111111111111111111111111111111111111111111111111111111111111111111111111111111111111111111111111111110
11111111111111111111111111111111111111111111111111111111111111111111111111111111111111111111111111111111111111111111111111111111111111111110
11111111111111111111111111111111111111111111111111111111111111111111111111111111111111111111111111111111111111111111111111111111111111111110
11111111111111111111111111111111111111111111111111111111111111111111111111111111111111111111111111111111111111111111111111111111111111111110
11111111111111111111111111111111111111111111111111111111111111111111111111111111111111111111111111111111111111111111111111111111111111111110
11111111111111111111111111111111111111111111111111111111111111111111111111111111111111111111111111111111111111111111111111111111111111111110
11111111111111111111111111111111111111111111111111111111111111111111111111111111111111111111111111111111111111111111111111111111111111111110
11111111111111111111111111111111111111111111111111111111111111111111111111111111111111111111111111111111111111111111111111111111111111111110
