11111111111111111111111111111111111111111111111111111111111111111111111111111111111111111111111111111111111111111111111111111111111111111110
11111111111111111111111111111111111111111111111111111111111111111111111111111111111111111111111111111111111111111111111111111111111111111110
11111111111111111111111111111111111111111111111111111111111111111111111111111111111111111111111111111111111111111111111111111111111111111110
11111111111111111111111111111111111111111111111111111111111111111111111111111111111111111111111111111111111111111111111111111111111111111110
11111111111111111111111111111111111111111111111111111111111111111111111111111111111111111111111111111111111111111111111111111111111111111110
11111111111111111111111111111111111111111111111111111111111111111111111111111111111111111111111111111111111111111111111111111111111111111110
11111111111111111111111111111111111111111111111111111111111111111111111111111111111111111111111111111111111111111111111111111111111111111110
11111111111111111111111111111111111111111111111111111111111111111111111111111111111111111111111111111111111111111111111111111111111111111110
11111111111111111111111111111111111111111111111111111111111111111111111111111111111111111111111111111111111111111111111111111111111111111110
11111111111111111111111111111111111111111111111111111111111111111111111111111111111111111111111111111111111111111111111111111111111111111110
11111111111111111111111111111111111111111111111111111111111111111111111111111111111111111111111111111111111111111111111111111111111111111110
11111111111111111111111111111111111111111111111111111111111111111111111111111111111111111111111111111111111111111111111111111111111111111110
11111111111111111111111111111111111111000000000000000000000000001111111111110000000000000000000000000011111111111111111111111111111111111110
11111111111111111111111111111111111111000000000000000000000000001111111111110000000000000000000000000011111111111111111111111111111111111110
11111111111111111111111111111111110000000000000000000000000000000011111111000000000000000000000000000000001111111111111111111111111111111110
11111111111111111111111111111111110000000000000000000000000000000011111111000000000000000000000000000000001111111111111111111111111111111110
11111111111111111111111111111111110000000000000000000000000000000000111100000000000000000000000000000000001111111111111111111111111111111110
11111111111111111111111111111111110000000000000000000000000000000000111100000000000000000000000000000000001111111111111111111111111111111110
11111111111111111111111111111111111100000000000000000000000000000000111100000000000000000000000000000000111111111111111111111111111111111110
11111111111111111111111111111111111100000000000000000000000000000000111100000000000000000000000000000000111111111111111111111111111111111110
11111111111111111111111111110000111111000000000000000000000000000000111100000000000000000000000000000011111100001111111111111111111111111110
11111111111111111111111111110000111111000000000000000000000000000000111100000000000000000000000000000011111100001111111111111111111111111110
11111111111111111111111111110000001111110000000000000000000000000000000000000000000000000000000000001111110000001111111111111111111111111110
11111111111111111111111111110000001111110000000000000000000000000000000000000000000000000000000000001111110000001111111111111111111111111110
11111111111111111111111111000000000011000000000000000000000000000000000000000000000000000000000000000011000000000011111111111111111111111110
11111111111111111111111111000000000011000000000000000000000000000000000000000000000000000000000000000011000000000011111111111111111111111110
11111111111111111111111111000000000000000000000000000000000000000000000000000000000000000000000000000000000000000011111111111111111111111110
11111111111111111111111111000000000000000000000000000000000000000000000000000000000000000000000000000000000000000011111111111111111111111110
11111111111111111111111111000000000000000000000000000000000000000000111100000000000000000000000000000000000000000011111111111111111111111110
11111111111111111111111111000000000000000000000000000000000000000000111100000000000000000000000000000000000000000011111111111111111111111110
11111111111111111111111111000000000000000000001100000000000000000000111100000000000000000000110000000000000000000011111111111111111111111110
11111111111111111111111111000000000000000000001100000000000000000000111100000000000000000000110000000000000000000011111111111111111111111110
11111111111111111111111111000000000000000000111111000000000000000000111100000000000000000011111100000000000000000011111111111111111111111110
11111111111111111111111111000000000000000000111111000000000000000000111100000000000000000011111100000000000000000011111111111111111111111110
11111111111111111111111111000011000000000000001111110000000000000000111100000000000000001111110000000000000011000011111111111111111111111110
11111111111111111111111111000011000000000000001111110000000000000000111100000000000000001111110000000000000011000011111111111111111111111110
11111111111111111111111111000000000000000000000011111100000000000000111100000000000000111111000000000000000000000011111111111111111111111110
11111111111111111111111111000000000000000000000011111100000000000000111100000000000000111111000000000000000000000011111111111111111111111110
11111111111111111111111111000000000000000000000000111111000000000000111100000000000011111100000000000000000000000011111111111111111111111110
11111111111111111111111111000000000000000000000000111111000000000000111100000000000011111100000000000000000000000011111111111111111111111110
11111111111111111111111111000000000000000000000000111111000000000000111100000000000011111100000000000000000000000011111111111111111111111110
11111111111111111111111111000000000000000000000000111111000000000000111100000000000011111100000000000000000000000011111111111111111111111110
11111111111111111111111111000000000000000000000000111111000000000000111100000000000011111100000000000000000000000011111111111111111111111110
11111111111111111111111111000000000000000000000000111111000000000000111100000000000011111100000000000000000000000011111111111111111111111110
11111111111111111111111111000000000000000000000000111111000000000000111100000000000011111100000000000000000000000011111111111111111111111110
11111111111111111111111111000000000000000000000000111111000000000000111100000000000011111100000000000000000000000011111111111111111111111110
11111111111111111111111111000011000000000000000001111111000000000000111100000000000011111110000000000000000011000011111111111111111111111110
11111111111111111111111111000011000000000000000000111111000000000000111100000000000011111100000000000000000011000011111111111111111111111110
11111111111111111111111111000000000000000000000000111111000000000000111100000000000011111100000000000000000000000011111111111111111111111110
11111111111111111111111111000000000000000000000001111111000000000000111100000000000011111110000000000000000000000011111111111111111111111110
11111111111111111111111111000000000000000000000000111111000000000000111100000000000011111100000000000000000000000011111111111111111111111110
11111111111111111111111111000000000000000000000000111111000000000000111100000000000011111100000000000000000000000011111111111111111111111110
11111111111111111111111111000000000000000000000001111111000000000000111100000000000011111110000000000000000000000011111111111111111111111110
11111111111111111111111111000000000000000000000000111111000000000000111100000000000011111100000000000000000000000011111111111111111111111110
11111111111111111111111111000000000000000000000000111111000000000000111100000000000011111100000000000000000000000011111111111111111111111110
11111111111111111111111111000000000000000000000001111111000000000000111100000000000011111110000000000000000000000011111111111111111111111110
11111111111111111111111111000000000000000000000000111111000000000000111100000000000011111100000000000000000000000011111111111111111111111110
11111111111111111111111111000000000000000000000000111111000000000000111100000000000011111100000000000000000000000011111111111111111111111110
11111111111111111111111111000011000000000000000000111111000000000000111100000000000011111100000000000000000011000011111111111111111111111110
11111111111111111111111111000011000000000000000000111111000000000000111100000000000011111100000000000000000011000011111111111111111111111110
11111111111111111111111111000000000000000000000000111111000000000000111100000000000011111100000000000000000000000011111111111111111111111110
11111111111111111111111111000000000000000000000000111111000000000000111100000000000011111100000000000000000000000011111111111111111111111110
11111111111111111111111111000000000000000000000011111111000000000000111100000000000011111111000000000000000000000011111111111111111111111110
11111111111111111111111111000000000000000000000011111111000000000000111100000000000011111111000000000000000000000011111111111111111111111110
11111111111111111111111111111100000000111111111111111111000000000000111100000000000011111111111111111100000000111111111111111111111111111110
11111111111111111111111111111100000000111111111111111111000000000000111100000000000011111111111111111100000000111111111111111111111111111110
11111111111111111111111111111100000000111111111111111111000000000000111100000000000011111111111111111100000000111111111111111111111111111110
11111111111111111111111111111100000000111111111111111111000000000000111100000000000011111111111111111100000000111111111111111111111111111110
11111111111111111111111111111100000000111111111111111111000000000000111100000000000011111111111111111100000000111111111111111111111111111110
11111111111111111111111111111100000000111111111111111111000000000000111100000000000011111111111111111100000000111111111111111111111111111110
11111111111111111111111111111100000000111111111111111111111100000011111111000000111111111111111111111100000000111111111111111111111111111110
11111111111111111111111111111100000000111111111111111111111100000011111111000000111111111111111111111100000000111111111111111111111111111110
11111111111111111111111111000000000000000000001111111111111100000011111111000000111111111111110000000000000000000011111111111111111111111110
11111111111111111111111111000000000000000000001111111111111100000011111111000000111111111111110000000000000000000011111111111111111111111110
11111111111111111111111111000011000000000000001111111111011100000011111111000000111011111111110000000000000011000011111111111111111111111110
11111111111111111111111111000011000000000000001111111111000000000011111111000000000011111111110000000000000011000011111111111111111111111110
11111111111111111111111111000000000000000000001111111100000000000011111111000000000000111111110000000000000000000011111111111111111111111110
11111111111111111111111111000000000000000000001111111100000000000000111100000000000000111111110000000000000000000011111111111111111111111110
11111111111111111111111111000000000000000000001111110000000000000000111100000000000000001111110000000000000000000011111111111111111111111110
11111111111111111111111111000000000000000000001111110000000000000000111100000000000000001111110000000000000000000011111111111111111111111110
11111111111111111111111111000000000000000000001111000000000000000000111100000000000000000011110000000000000000000011111111111111111111111110
11111111111111111111111111000000000000000000001111100000000000000000111100000000000000000111110000000000000000000011111111111111111111111110
11111111111111111111111111000000000000000000001111100000000000000000111100000000000000000111110000000000000000000011111111111111111111111110
11111111111111111111111111000000000000000000001111100000000000000000111100000000000000000111110000000000000000000011111111111111111111111110
11111111111111111111111111000000000000000000000000000000000000000000111100000000000000000000000000000000000000000011111111111111111111111110
11111111111111111111111111000000000000000000000000000000000000000000111100000000000000000000000000000000000000000011111111111111111111111110
11111111111111111111111111000011000000000000000000000000000000000000111100000000000000000000000000000000000011000011111111111111111111111110
11111111111111111111111111000011000000000000000000000000000000000000111100000000000000000000000000000000000011000011111111111111111111111110
11111111111111111111111111110000000000000000000000000000000000000000111100000000000000000000000000000000000000001111111111111111111111111110
11111111111111111111111111110000000000000000000000000000000000000000111100000000000000000000000000000000000000001111111111111111111111111110
11111111111111111111111111111100000000000000001111111000000000000011111111000000000000011111110000000000000000111111111111111111111111111110
11111111111111111111111111111100000000000000001111111000000000000011111111000000000000011111110000000000000000111111111111111111111111111110
11111111111111111111111111111111000000000000111111111111111111111111111111111111111111111111111100000000000011111111111111111111111111111110
11111111111111111111111111111111000000000000111111111111111111111111111111111111111111111111111100000000000011111111111111111111111111111110
11111111111111111111111111111111000000000000111111111111111111111111111111111111111111111111111100000000000011111111111111111111111111111110
11111111111111111111111111111111000000000000111111111111111111111111111111111111111111111111111100000000000011111111111111111111111111111110
11111111111111111111111111111100000000000000001111111000000000000011111111000000000000011111110000000000000000111111111111111111111111111110
11111111111111111111111111111100000000000000001111111000000000000011111111000000000000011111110000000000000000111111111111111111111111111110
11111111111111111111111111110000000000000000000000000000000000000000111100000000000000000000000000000000000000001111111111111111111111111110
11111111111111111111111111110011000000000000000000000000000000000000111100000000000000000000000000000000000011001111111111111111111111111110
11111111111111111111111111000011000000000000000000000000000000000000111100000000000000000000000000000000000011000011111111111111111111111110
11111111111111111111111111000000000000000000000000000000000000000000111100000000000000000000000000000000000000000011111111111111111111111110
11111111111111111111111111000000000000000000000000000000000000000000111100000000000000000000000000000000000000000011111111111111111111111110
11111111111111111111111111000000000000000000000000000000000000000000111100000000000000000000000000000000000000000011111111111111111111111110
11111111111111111111111111000000000000000000001111100000000000000000111100000000000000000111110000000000000000000011111111111111111111111110
11111111111111111111111111000000000000000000001111100000000000000000111100000000000000000111110000000000000000000011111111111111111111111110
11111111111111111111111111000000000000000000001111100000000000000000111100000000000000000111110000000000000000000011111111111111111111111110
11111111111111111111111111000000000000000000001111000000000000000000111100000000000000000011110000000000000000000011111111111111111111111110
11111111111111111111111111000000000000000000001111110000000000000000111100000000000000001111110000000000000000000011111111111111111111111110
11111111111111111111111111000000000000000000001111110000000000000000111100000000000000001111110000000000000000000011111111111111111111111110
11111111111111111111111111000000000000000000001111111100000000000000111100000000000000111111110000000000000000000011111111111111111111111110
11111111111111111111111111000011000000000000001111111100000000000011111111000000000000111111110000000000000011000011111111111111111111111110
11111111111111111111111111000011000000000000001111111111000000000011111111000000000011111111110000000000000011000011111111111111111111111110
11111111111111111111111111000000000000000000001111111111011100000011111111000000111011111111110000000000000000000011111111111111111111111110
11111111111111111111111111111100000000111111111111111111111100000011111111000000111111111111110000000000000000000011111111111111111111111110
11111111111111111111111111111100000000111111111111111111111100000011111111000000111111111111110000000000000000000011111111111111111111111110
11111111111111111111111111111100000000111111111111111111111100000011111111000000111111111111111111111100000000111111111111111111111111111110
11111111111111111111111111111100000000111111111111111111111100000011111111000000111111111111111111111100000000111111111111111111111111111110
11111111111111111111111111111100000000111111111111111111000000000000111100000000000011111111111111111100000000111111111111111111111111111110
11111111111111111111111111111100000000111111111111111111000000000000111100000000000011111111111111111100000000111111111111111111111111111110
11111111111111111111111111111100000000111111111111111111000000000000111100000000000011111111111111111100000000111111111111111111111111111110
11111111111111111111111111111100000000111111111111111111000000000000111100000000000011111111111111111100000000111111111111111111111111111110
11111111111111111111111111000000000000000000000011111111000000000000111100000000000011111111111111111100000000111111111111111111111111111110
11111111111111111111111111000000000000000000000011111111000000000000111100000000000011111111111111111100000000111111111111111111111111111110
11111111111111111111111111000011000000000000000000111111000000000000111100000000000011111111000000000000000011000011111111111111111111111110
11111111111111111111111111000011000000000000000000111111000000000000111100000000000011111111000000000000000011000011111111111111111111111110
11111111111111111111111111000000000000000000000000111111000000000000111100000000000011111100000000000000000000000011111111111111111111111110
11111111111111111111111111000000000000000000000000111111000000000000111100000000000011111100000000000000000000000011111111111111111111111110
11111111111111111111111111000000000000000000000000111111000000000000111100000000000011111100000000000000000000000011111111111111111111111110
11111111111111111111111111000000000000000000000000111111000000000000111100000000000011111100000000000000000000000011111111111111111111111110
11111111111111111111111111000000000000000000000000111111000000000000111100000000000011111100000000000000000000000011111111111111111111111110
11111111111111111111111111000000000000000000000000111111000000000000111100000000000011111100000000000000000000000011111111111111111111111110
11111111111111111111111111000000000000000000000000111111000000000000111100000000000011111100000000000000000000000011111111111111111111111110
11111111111111111111111111000000000000000000000000111111000000000000111100000000000011111100000000000000000000000011111111111111111111111110
11111111111111111111111111000000000000000000000001111111000000000000111100000000000011111110000000000000000000000011111111111111111111111110
11111111111111111111111111000000000000000000000000111111000000000000111100000000000011111100000000000000000000000011111111111111111111111110
11111111111111111111111111000011000000000000000000111111000000000000111100000000000011111100000000000000000011000011111111111111111111111110
11111111111111111111111111000011000000000000000001111111000000000000111100000000000011111110000000000000000011000011111111111111111111111110
11111111111111111111111111000000000000000000000000111111000000000000111100000000000011111100000000000000000000000011111111111111111111111110
11111111111111111111111111000000000000000000000000111111000000000000111100000000000011111100000000000000000000000011111111111111111111111110
11111111111111111111111111000000000000000000000001111111000000000000111100000000000011111110000000000000000000000011111111111111111111111110
11111111111111111111111111000000000000000000000000111111000000000000111100000000000011111100000000000000000000000011111111111111111111111110
11111111111111111111111111000000000000000000000000111111000000000000111100000000000011111100000000000000000000000011111111111111111111111110
11111111111111111111111111000000000000000000000001111111000000000000111100000000000011111110000000000000000000000011111111111111111111111110
11111111111111111111111111000000000000000000000000111111000000000000111100000000000011111100000000000000000000000011111111111111111111111110
11111111111111111111111111000000000000000000000000111111000000000000111100000000000011111100000000000000000000000011111111111111111111111110
11111111111111111111111111000000000000000000000000111111000000000000111100000000000011111100000000000000000000000011111111111111111111111110
11111111111111111111111111000000000000000000000000111111000000000000111100000000000011111100000000000000000000000011111111111111111111111110
11111111111111111111111111000011000000000000000000111111000000000000111100000000000011111100000000000000000011000011111111111111111111111110
11111111111111111111111111000011000000000000000000111111000000000000111100000000000011111100000000000000000011000011111111111111111111111110
11111111111111111111111111000000000000000000000000111111000000000000111100000000000011111100000000000000000000000011111111111111111111111110
11111111111111111111111111000000000000000000000000111111000000000000111100000000000011111100000000000000000000000011111111111111111111111110
11111111111111111111111111000000000000000000000011111100000000000000111100000000000000111111000000000000000000000011111111111111111111111110
11111111111111111111111111000000000000000000000011111100000000000000111100000000000000111111000000000000000000000000111111111111111111111110
11111111111111111111111100000000000000000000001111110000000000000000111100000000000000001111110000000000000000000000111111111111111111111110
11111111111111111111111100000000000000000000001111110000000000000000111100000000000000001111110000000000000000000000111111111111111111111110
11111111111111111111111100000000000000000000111111000000000000000000111100000000000000000011111100000000000000000000111111111111111111111110
11111111111111111111111100000000000000000000111111000000000000000000111100000000000000000011111100000000000000000000111111111111111111111110
11111111111111111111111100000000000000000000001100000000000000000000111100000000000000000000110000000000000000000000111111111111111111111110
11111111111111111111111111000000000000000000001100000000000000000000111100000000000000000000110000000000000000000011111111111111111111111110
11111111111111111111111111000000000000000000000000000000000000000000111100000000000000000000000000000000000000000011111111111111111111111110
11111111111111111111111111000000000000000000000000000000000000000000111100000000000000000000000000000000000000000011111111111111111111111110
11111111111111111111111111000011000000000000000000000000000000000000111100000000000000000000000000000000000011000011111111111111111111111110
11111111111111111111111111000011000000000000000000000000000000000000111100000000000000000000000000000000000011000011111111111111111111111110
11111111111111111111111111000000000011000000000000000000000000000000111100000000000000000000000000000011000000000011111111111111111111111110
11111111111111111111111111000000000011000000000000000000000000000000111100000000000000000000000000000011000000000011111111111111111111111110
11111111111111111111111111110000001111110000000000000000000000000000111100000000000000000000000000001111110000001111111111111111111111111110
11111111111111111111111111110000001111110000000000000000000000000000111100000000000000000000000000001111110000001111111111111111111111111110
11111111111111111111111111110000111111000000000000000000000000000000111100000000000000000000000000000011111100001111111111111111111111111110
11111111111111111111111111110000111111000000000000000000000000000000111100000000000000000000000000000011111100001111111111111111111111111110
11111111111111111111111111111111111100000000000000000000000000000000111100000000000000000000000000000000111111111111111111111111111111111110
11111111111111111111111111111111111100000000000000000000000000000000111100000000000000000000000000000000111111111111111111111111111111111110
11111111111111111111111111111111110000000000000000000000000000000000111100000000000000000000000000000000001111111111111111111111111111111110
11111111111111111111111111111111110000000000000000000000000000000000111100000000000000000000000000000000001111111111111111111111111111111110
11111111111111111111111111111111110000000000000000000000000000000011111111000000000000000000000000000000001111111111111111111111111111111110
11111111111111111111111111111111110000000000000000000000000000000011111111000000000000000000000000000000001111111111111111111111111111111110
11111111111111111111111111111111111111000000000000000000000000001111111111110000000000000000000000000011111111111111111111111111111111111110
11111111111111111111111111111111111111000000000000000000000000001111111111110000000000000000000000000011111111111111111111111111111111111110
11111111111111111111111111111111111111111111111111111111111111111111111111111111111111111111111111111111111111111111111111111111111111111110
11111111111111111111111111111111111111111111111111111111111111111111111111111111111111111111111111111111111111111111111111111111111111111110
11111111111111111111111111111111111111111111111111111111111111111111111111111111111111111111111111111111111111111111111111111111111111111110
11111111111111111111111111111111111111111111111111111111111111111111111111111111111111111111111111111111111111111111111111111111111111111110
11111111111111111111111111111111111111111111111111111111111111111111111111111111111111111111111111111111111111111111111111111111111111111110
11111111111111111111111111111111111111111111111111111111111111111111111111111111111111111111111111111111111111111111111111111111111111111110
11111111111111111111111111111111111111111111111111111111111111111111111111111111111111111111111111111111111111111111111111111111111111111110
11111111111111111111111111111111111111111111111111111111111111111111111111111111111111111111111111111111111111111111111111111111111111111110
11111111111111111111111111111111111111111111111111111111111111111111111111111111111111111111111111111111111111111111111111111111111111111110
11111111111111111111111111111111111111111111111111111111111111111111111111111111111111111111111111111111111111111111111111111111111111111110
11111111111111111111111111111111111111111111111111111111111111111111111111111111111111111111111111111111111111111111111111111111111111111110
11111111111111111111111111111111111111111111111111111111111111111111111111111111111111111111111111111111111111111111111111111111111111111110
11111111111111111111111111111111111111111111111111111111111111111111111111111111111111111111111111111111111111111111111111111111111111111110
11111111111111111111111111111111111111111111111111111111111111111111111111111111111111111111111111111111111111111111111111111111111111111110
11111111111111111111111111111111111111111111111111111111111111111111111111111111111111111111111111111111111111111111111111111111111111111110
11111111111111111111111111111111111111111111111111111111111111111111111111111111111111111111111111111111111111111111111111111111111111111110
11111111111111111111111111111111111111111111111111111111111111111111111111111111111111111111111111111111111111111111111111111111111111111110
11111111111111111111111111111111111111111111111111111111111111111111111111111111111111111111111111111111111111111111111111111111111111111110
11111111111111111111111111111111111111111111111111111111111111111111111111111111111111111111111111111111111111111111111111111111111111111110
11111111111111111111111111111111111111111111111111111111111111111111111111111111111111111111111111111111111111111111111111111111111111111110
11111111111111111111111111111111111111111111111111111111111111111111111111111111111111111111111111111111111111111111111111111111111111111110
11111111111111111111111111111111111111111111111111111111111111111111111111111111111111111111111111111111111111111111111111111111111111111110
