0000000000000000000000000000000000000000000000000000000000000000000000000000000000000000000000000000
1111111111111111111111111111111111111111111111111111111111111111111111111111111111111111111111111110
1111111111111111111111111111111111111111111111111111111111111111111111111111111111111111111111111110
1111111111111111111111111111111111111111111111111111111111111111111111111111111111111111111111111110
1111111111111111111111111111111111111111111111111111111111111111111111111111111111111111111111111110
1111111111111111111111111111111111111111111111111111111111111111111111111111111111111111111111111110
1111111111111111111111111111111111111111111111111111111111111111111111111111111111111111111111111110
1111111111111111111111111111111111111111111111111111111111111111111111111111111111111111111111111110
1111111111111111111111111111111111111111111111111111111111111111111111111111111111111111111111111110
1111111111111111111111111111111111111111111111111111111111111111111111111111111111111111111111111110
1111111111111111111111111111111111111000111111111111111111111111111111111111111111111111111111111110
1111111111111111111111111111111111111000000000001111111111111111111111111111111111111111111111111110
1111111111111111111111111111111111111000000000001111111111111111111111111111111111111111111111111110
1111111111111111111111111111111111000000000000001111111111111111111111111111111111111111111111111110
1111111111111111111111111111111111000000000000000111111111111111111111111111111111111111111111111110
1111111111111111111111111111111111000000000000000111111111111111111111111111111111111111111111111110
1111111111111111111111111111111110000000000000000111111111111111111111111111111111111111111111111110
1111111111111111111111111111111000000000000000000000111111111111111111111111111111111111111111111110
1111111111111111111100000011110000000000000000000000110000111111111111111111111111111111111111111110
1111111111111110000000000011100000000000000000000000000000111111111111111111111111111111111111111110
1111111111111000000000000000000000000000000000000000000000111111111111111111111111111111111111111110
1111111111111000000000000000000000000000000000000000000000011111111111111111111111111111111111111110
1111111111110000000000000000000000000000000000000000000000011111111111111111111111111111111111111110
1111111111111000000000000000000000000000000000000000000000001111111111111111111111111111111111111110
1111111111111100000000000000000000000000000000000000000000000011111111111111110111100000001111111110
1111111111111111100000000001110000000000000000000000000000000001111111111111100110000000001111111110
1111111111111111000000000011110000000000000000000000000000000000011111111111000000000000001111111110
1111111111111110000000111111110000110000000000000000000000000000001111111110000000000000001111111110
1111111111111111000000111100000000111000000001100000000000000000000000001110000000000000001111111110
1111111111111111000000000000000000111111000001000000000000000000000000001100000000000000000111111110
1111111111111111100000000000001010111111111111000111111000000000000000000000000000000000000111111110
1111111111111111110000000000011110001111111111111111111000000000000000000000000000000000000111111110
1111111111111111111000000000011110000111100010011111110000000000000000000000000000000000001111111110
1111111111111111111000000000111110000001000000000111100000000011000000000000000000000000001111111110
1111111111111111111000000000111111000001000000000001000000000110000000000000000000000000001111111110
1111111111111111111000000000011111100000000000000000000000001110000000000000000000000000001111111110
1111111111111111111000000000000100000000000000000000000011111100000000000000000000000000001111111110
1111111111111111111000000000000001000000000000000000000011111100000000000000000000000000001111111110
1111111111111111111000000001100000000000000000000000011111111100000000001100000011011111111111111110
1111111111111111111000000001110000000000000000000000111111111100000000001100000011111111111111111110
1111111111111111111000000000111000000000000000000000111111111100000000001110000001111111111111111110
1111111111111111111000000001111100000000000000000000001111111000000000001110000001111111111111111110
1111111111111111111000011111111111000000000000000000000011100000000000000000000011111111111111111110
1111111111111111111000111111111111000000000110000000000011100000000000000000000000111111111111111110
1111111111111111111111111111111111000000000110000000000011100000000000000000000000111111111111111110
1111111111111111101111100011111111110000000110000000000011100000000000000000000011111111111111111110
1111111111111111101100000000000110110000000100000000001111100000000000000000000011111111111111111110
1111111111111111000100000000000010000000001100000000000111100000000000000000000111111111111111111110
1111111111000000010000000000000000000000000000000000000111110000001110000000001111111111111111111110
1111111110000000111000000000000000000000000000000000000111110000011110000000001111111111111111111110
1111111110000000011100000000000000000000000000000111000011111000011111000000000011111111111111111110
1111111110000000000000000000000000000000000000000111111111111000011111000000000111111111111111111110
1111111110000000000000000000000000000000000000000011111111111100000111100000011111111111111111111110
1111111100000000000000000000000000000000000000011011111111110110000001111111111111111111111111111110
1111111100000000000000000000000000000000000000001111111111110000000000111111111111111111111111111110
1111111100000000000000000000000000000000000000001110000110000000000000011011111111111111111111111110
1111111110000000000000000000000000000000011000011110000000000000000000000011111111111111111111111110
1111111110000000000000000000000000000000011110011110000000000000000000000011111111111111111111111110
1111111110000000000000000000001100000001111111111110000000000000000000000011111111111111111111111110
1111111110000000000000000000001110000001111111111110000000000000000000000011111111111111111111111110
1111111111000000001110000000001110000011111111110000000000001110000000000011111111111111111111111110
1111111111111111001111100000000000000111111111000000000000001110000000000111111111111111111111111110
1111111111111111111111111000011100111111110000000000000000001110000000011111111111111111111111111110
1111111111111111111111111100011111111101100000000000000000000000000000011110111111111111111111111110
1111111111111111111111111110011111111000111111100000000000000000000000000000011111111111111111111110
1111111111111111111111111111111111110000111111100000000000000000000000000000001111111111111111111110
1111111111111111111111111111111111000000111111100000000000000000000000000000000001111111111111111110
1111111111111111111111111100000110000000000000000000000000001000100000000000000000111111111111111110
1111111111111111110111111000000110000000000000000000000000001111100000001100000000111111111111111110
1111111111111111110111110000000100000000000000000000000000001111000000001111000000111111111111111110
1111111111111111110111110000000000000000000000000000000000011111000000001111000000111111111111111110
1111111111111111110000110000001000000000000000000000000000011110000000000110000000111111111111111110
1111111111111111110000000000011110000000000000000000000000111111000000000000000000111111111111111110
1111111111111111110000000000001111000000000000000000000011111111111100000000000000111111111111111110
1111111111111111110000000000001111000000000000001111111111111111111111000000000000111111111111111110
1111111111111111110000000000001100000000000000011111111111111111111111100000000000111111111111111110
1111111111111111110000000000001100000000000011111111111111111111111111110000000000111111111111111110
1111111111111111111100000000000000000000001111111111111111111111111111111000000111111111111111111110
1111111111111111111111000000000000000000001111111111111111111111111111111000001111111111111111111110
1111111111111111111111000000000000000000011111111111111111111111111111111100011111111111111111111110
1111111111111111111111000000000000011111111111111111111111111111111111111100111111111111111111111110
1111111111111111111111111110000000111111111111111111111111111111111111111111111111111111111111111110
1111111111111111111111111111111111111111111111111111111111111111111111111111111111111111111111111110
1111111111111111111111111111111111111111111111111111111111111111111111111111111111111111111111111110
1111111111111111111111111111111111111111111111111111111111111111111111111111111111111111111111111110
1111111111111111111111111111111111111111111111111111111111111111111111111111111111111111111111111110
1111111111111111111111111111111111111111111111111111111111111111111111111111111111111111111111111110
1111111111111111111111111111111111111111111111111111111111111111111111111111111111111111111111111110
1111111111111111111111111111111111111111111111111111111111111111111111111111111111111111111111111110
1111111111111111111111111111111111111111111111111111111111111111111111111111111111111111111111111110
1111111111111111111111111111111111111111111111111111111111111111111111111111111111111111111111111110
1111111111111111111111111111111111111111111111111111111111111111111111111111111111111111111111111110
1111111111111111111111111111111111111111111111111111111111111111111111111111111111111111111111111110
1111111111111111111111111111111111111111111111111111111111111111111111111111111111111111111111111110
1111111111111111111111111111111111111111111111111111111111111111111111111111111111111111111111111110
1111111111111111111111111111111111111111111111111111111111111111111111111111111111111111111111111110
1111111111111111111111111111111111111111111111111111111111111111111111111111111111111111111111111110
1111111111111111111111111111111111111111111111111111111111111111111111111111111111111111111111111110
1111111111111111111111111111111111111111111111111111111111111111111111111111111111111111111111111110
1111111111111111111111111111111111111111111111111111111111111111111111111111111111111111111111111110
