0000000000000000000000000000000000000000000000000000000000000000000000000000000000000000000000000000
1111111111111111111111111111111111111111111111111111111111111111111111111111111111111111111111111110
1111111111111111111111111111111111111111111111111111111111111111111111111111111111111111111111111110
1111111111111111111111111111111111111111111111111111111111111111111111111111111111111111111111111110
1111111111111111111111111111111111111111111111111111111111111111111111111111111111111111111111111110
1111111111111111111111111111111111111111111111111111111111111111111111111111111111111111111111111110
1111111111111111111111111111111111111111111111111111111111111111111111111111111111111111111111111110
1111111111111111111111111111111111111111111111111111111111111111111111111111111111111111111111111110
1111111111111111111111111111111111111111111111111111111111111111111111111111111111111111111111111110
1111111111111111111111111111111111111111111111111111111111111111111111111111111111111111111111111110
1111111111111111111111111111111111111111111111111111111111111111111111111111111111111111111111111110
1111111111111111111111111111111111111111111111111111111111111111111111111111111111111111111111111110
1111111111111111111111111111111111111111111111111111111111111111111111111111111111111111111111111110
1111111111111111111111111111111111111111111111111111111111111111111111111111111111111111111111111110
1111111111111111111111111111111111111111111111111111111111111111111111111111111111111111111111111110
1111111111111111111111111111111111111111111111111111111111111111111111111111111111111111111111111110
1111111111111111111111111111111111111111111111111111111111111111111111111111111111111111111111111110
1111111111111111111111111111111111111111111111111111111111111111111111111111111111111111111111111110
1111111111111111111111111111111111111111111111111111111111111111111111111111111111111111111111111110
1111111111111111111111111111111111111111111111111111111111111111111111111111111111111111111111111110
1111111111111111111111111111111111111111111111111111111111111111111111111111111111111111111111111110
1111111111111111111111111111111111111111111111111111111111111111111111111111111111111111111111111110
1111111111111111111111111111111111111111111111111111111111111111111111111111111111111111111111111110
1111111111111111111111111111111111111111111111111111111111111111111111111111111111111111111111111110
1111111111111111111111111111111111111111111111111111111111111111111111111111111111111111111111111110
1111111111111111111111111111111111111111111111111111111111111111111111111111111111111111111111111110
1111111111111111111111111111111111111111111111111111111111111111111111111111111111111111111111111110
1111111111111111111111111111111111111111111111111111111111111111111111111111111111111111111111111110
1111111111111111111111111111111111111111111111111111111111111111111111111111111111111111111111111110
1111111111111111111111111111111111111111111111111111111111111111111111111111111111111111111111111110
1111111111111111111111111111111111111111111111111111111111111111111111111111111111111111111111111110
1111111111111111111111111111111111111111111111111111111111111111111111111111111111111111111111111110
1111111111111111111111111111111111111111111111111111111111111111111111111111111111111111111111111110
1111111111111111111111111111111111111111111111111111111111111111111111111111111111111111111111111110
1111111111111111111111111111111100000000000000000000000000000000000000000000000000000011111111111110
1111111111111111111111111111111100000000000000000000000000000000000000000000000000000011111111111110
1111111111111111111111111111111100000000000000000000000000000000000000000000000000000011111111111110
1111111111111111111111111111111100000000000000000000000000000000000000000000000000000011111111111110
1111111111111111111111111111111100000000000000000000000000000000000000000000000000000011111111111110
1111111111111111111111111111111100000000000000000000000000000000000000000000000000001111111111111110
1111111111111111111111111111111100000000000000000000000000000000000000000000000000001111111111111110
1111111111111111111111111111111100000000000000000000000000000000000000000000000000001111111111111110
1111111111111111111111111111111100000000000000000000000000000000000000000000000000001111111111111110
1111111111111111111111111111111100011111111111111111111111111111111111111111111100001111111111111110
1111111111111111111111111111111110010001000000100000000000001100000001111111111100001111111111111110
1111111111111111111111111111111110010000000000000000000000000000000001111111111100001111111111111110
1111111111111111001111110000011110010000000000000000000000000000000001111111111100001111111111111110
1111111111111111001111110000011110010000000000000000000000000000000001111111111100001111111111111110
1111111111111111001111110000000000010000000000000000000000000000000001111111111100001111111111111110
1111111111111111000111100000000000010000000000000000000000000000000000111111111100001111111111111110
1111111111111111000000000000011111110000000000000000000000000000000000111111111100001111111111111110
1111111111111111000000000000000000000000000001111000000001111000000000111111111100001111111111111110
1111111111111111000000000000000000000000000001111000000001111000000000111111111100001111111111111110
1111111111111111000000000000000000000000000001111000000001111000000000111111111100001111111111111110
1111111111111111000000000000000000000000000001111000000001111000000000111111111100001111111111111110
1111111111111111000000000000000000000000000001111000000001111000000000111111111100001111111111111110
1111111111111111000000000000000000000000000001111000000001111000000000111111111100001111111111111110
1111111111111111111110000000000000000000000001111000000001111000000000111111111100001111111111111110
1111111111111111111111000000000000000000000001111000000001111000000000111111111100001111111111111110
1111111111111111111111000000000000000000000001111000000001111000000000111111111100001111111111111110
1111111111111111111110000000000000000000000001111000000001111000000000111111111100001111111111111110
1111111111111111111110000000000000000000000001111000000001111000000000111111111100000011111111111110
1111111111111111111111001111000000000000000001111000000001111000000000111100000100000011111111111110
1111111111111111111111101111110000000000000001111000000001111000000001111100000100000011111111111110
1111111111111111111111101111110000001111111111111111111111111111111111111100000000000011111111111110
1111111111111111111111111111000000001111111111111111111111111111111111111000000000000011111111111110
1111111111111111111111111111000000001111111111111111111111111111111111110000001111111111111111111110
1111111111111111111111111111000000001111111111111111111111111111111111100000001111111111111111111110
1111111111111111111111111111000000001111111111111111111111111111111111000000001111111111111111111110
1111111111111111111111111111000000000000000000000000000000000000000000000000001111111111111111111110
1111111111111111111111111111000000000000000000000000000000000000000000000000111111111111111111111110
1111111111111111111111111111000000000000000000000000000000000000000000000000111111111111111111111110
1111111111111111111111111111000000000000000000000000000000000000000011000000111111111111111111111110
1111111111111111111111111111000000000000000000000000000000000000000011000011111111111111111111111110
1111111111111111111111111111110000000000000000000000000000000000000011000011111111111111111111111110
1111111111111111111111111111110000000000000000000000000000000000111111111111111111111111111111111110
1111111111110000110000110000110000000000000000000000000000000000111111111111111111111111111111111110
1111111111110000000000000000000000000000000000000000000000000000001111110011111111111111111111111110
1111111111110000000000000000000000000000000000000000000000000000001111110011111111111111111111111110
1111111111110000000000000000000000000000000000000000000000000000001111110011111111111111111111111110
1111111111110000000000000000000000000000000000000000000000000000001111110011111111111111111111111110
1111111111110000000000000000000000000000000000000000000000000000001111110011111111111111111111111110
1111111111110000000000000000000000000000000000000000000000000000001111110011111111111111111111111110
1111111111110000000000000000000000000000000000000000000000000000000011000011111111111111111111111110
1111111111111111111111111111111111111111000000000000000000000000000011000011111111111111111111111110
1111111111111111111111111111111111111111000000000000000000000000000011000000111111111111111111111110
1111111111111111111111111111111111111111000000000000000000000000000000000000111111111111111111111110
1111111111111111111111111111111111111111000000000000000000000000000000000000111111111111111111111110
1111111111111111111111111111111111111111111111111111111111111111111111111111111111111111111111111110
1111111111111111111111111111111111111111111111111111111111111111111111111111111111111111111111111110
1111111111111111111111111111111111111111111111111111111111111111111111111111111111111111111111111110
1111111111111111111111111111111111111111111111111111111111111111111111111111111111111111111111111110
1111111111111111111111111111111111111111111111111111111111111111111111111111111111111111111111111110
1111111111111111111111111111111111111111111111111111111111111111111111111111111111111111111111111110
1111111111111111111111111111111111111111111111111111111111111111111111111111111111111111111111111110
1111111111111111111111111111111111111111111111111111111111111111111111111111111111111111111111111110
1111111111111111111111111111111111111111111111111111111111111111111111111111111111111111111111111110
1111111111111111111111111111111111111111111111111111111111111111111111111111111111111111111111111110
1111111111111111111111111111111111111111111111111111111111111111111111111111111111111111111111111110
1111111111111111111111111111111111111111111111111111111111111111111111111111111111111111111111111110
