00000000000000000000000000000000000000000000000000000000000000000000000000000000000000000000000000000000000000000000000000000000000000000000
11111111111111111111111111111111111111111111111111111111111111111111111111111111111111111111111111111111111111111111111111111111111111111110
11111111111111111111111111111111111111111111111111111111111111111111111111111111111111111111111111111111111111111111111111111111111111111110
11111111111111111111111111111111111111111111111111111111111111111111111111111111111111111111111111111111111111111111111111111111111111111110
11111111111111111111111111111111111111111111111111111111111111111111111111111111111111111111111111111111111111111111111111111111111111111110
11111111111111111111111111111111111111111111111111111111111111111111111111111111111111111111111111111111111111111111111111111111111111111110
11111111111111111111111111111111111111111111111111111111111111111111111111111111111111111111111111111111111111111111111111111111111111111110
11111111111111111111111111111111111111111111111111111111111111111111111111111111111111111111111111111111111111111111111111111111111111111110
11111111111111111111111111111111111111111111111111111111111111111111111111111111111111111111111111111111111111111111111111111111111111111110
11111111111111111111111111111111111111111111111111111111111111111111111111111111111111111111111111111111111111111111111111111111111111111110
11111111111111111111111111111111111111111111111111111111111111111111111111111111111111111111111111111111111111111111111111111111111111111110
11111111111111111111111111111111111111111111111111111111111111111111111111111111111111111111111111111111111111111111111111111111111111111110
11111111111111111111111111111111111111111111111111111111111111111111111111111111111111111111111111111111111111111111111111111111111111111110
11111111111111111111111111111111111111111111111111111111111111111111111111111111111111111111111111111111111111111111111111111111111111111110
11111111111111111111111111111111111111111111111111111111111111111111111111111111111111111111111111111111111111111111111111111111111111111110
11111111111111111111111111111111111111111111111111111111111111111111111111111111111111111111111111111111111111111111111111111111111111111110
11111111111111111111111111111111111111111111111111111111111111111111111111111111111111111111111111111111111111111111111111111111111111111110
11111111111111111111111111111111111111111111111111111111111111111111111111111111111111111111111111111111111111111111111111111111111111111110
11111111111111111111111111111111111111111111111111111111111111111111111111111111111111111111111111111111111111111111111111111111111111111110
11111111111111111111111111111111111111111111111111111111111111111111111111111111111111111111111111111111111111111111111111111111111111111110
11111111111111111111111111111111111111111111111111111111111111111111111111111111111111111111111111111111111111111111111111111111111111111110
11111111111111111111111111111111111111111111111111111111111111111111111111111111111111111111111111111111111111111111111111111111111111111110
11111111111111111111111111111111111111111111111111111111111111111111111111111111111111111111111111111111111111111111111111111111111111111110
11111111111111111111111111111111111111111111111111111111111111111111111111111111111111111111111111111111111111111111111111111111111111111110
11111111111111111111111111111111111111111111111111111111111111111111111111111111111111111111111111111111111111111111111111111111111111111110
11111111111111111111111111111111111111111111111111111111111111111111111111111111111111111111111111111111111111111111111111111111111111111110
11111111111111111111111111111111111111111111111111111111111111111111111111111111111111111111111111111111111111111111111111111111111111111110
11111111111111111111111111111111111111111111111111111111111111111111111111111111111111111111111111111111111111111111111111111111111111111110
11111111111111111111111111111111111111111111111111111111111111111111111111111111111111111111111111111111111111111111111111111111111111111110
11111111111111111111111111111111111111111111111111111111111111111111111111111111111111111111111111111111111111111111111111111111111111111110
11111111111111111111111111111111111111111111111111111111111111111111111111111111111111111111111111111111111111111111111111111111111111111110
11111111111111111111111111111111111111111111111111111111111111111111111111111111111111111111111111111111111111111111111111111111111111111110
11111111111111111111111111111111111111111111111111111111111111111111111111111111111111111111111111111111111111111111111111111111111111111110
11111111111111111111111111111111111111111111111111111111111111111111111111111111111111111111111111111111111111111111111111111111111111111110
11111111111111001100001111000000001111111111111111111111111111111111111111111111111111111111111111111111111111111111111111111111111111111110
11111111111111000000001111000000001111111111111111111111111111111111111111111111111111111111111111111111111111111111111111111111111111111110
11111111111111000001111000000000011111111111111111111111111111111111111111111111111111111111111111111111111111111111111111111111111111111110
11111111111111000001001000000000011111111111111111111111111111111111111111111111111111111111111111111111111111111111111111111111111111111110
11111111111111000110000000001000011111111111111111111111111111111111111111111111111111111111111111111111111111111111111111111111111111111110
11111111111111000100111000001000011111111111111111111111111111111111111111111111111111111111111111111111111111111111111111111111111111111110
11111111111111000100111000001000011111111111111111111111111111111111111111111111111111111111111111111111111111111111111111111111111111111110
11111111111111000110111000001000011111111111111111111111111111111111111111111111111111111111111111111111111111111111111111111111111111111110
11111111111111000000000000000000011111111111111111111111111111111111111111111111111111111111111111111111111111111111111111111111111111111110
11111111111111000000000000000000011111111111111111111111111111111111111111111111111111111111111111111111111111111111111111111111111111111110
11111111111111000000000000000000001111111111111111111111111111111111111111111111111111111111111111111111111111111111111111111111111111111110
11111111111111000000000000000000001111111111111111111111111111111111111111111111111111111111111111111111111111111111111111111111111111111110
11111111111111110000001111111111111111111111111111111111111111111111111111111111111111111111111111111111111111111111111111111111111111111110
11111111111111110000001111111111111111111111111111111111111111111111111111111111111111111111111111111111111111111111111111111111111111111110
11111111111111111111111111111111111111111111111111111111111111111111111111111111111111111111111111111111111111111111111111111111111111111110
11111111111111111111111111111111111111111111111111111111111111111111111111111111111111111111111111111111111111111111111111111111111111111110
11111111111111111111111111111111111111111111111111111111111111111111111111111111111111111111111111111111111111111111111111111111111111111110
11111111111111111111111111111111111111111111111111111111111111111111111111111111111111111111111111111111111111111111111111111111111111111110
11111111111111111111111111111111111111111111111111111111111111111111111111111111111111111111111111111111111111111111111111111111111111111110
11111111111111111111111111111111111111111111111111111111111111111111111111111111111111111111111111111111111111111111111111111111111111111110
11111111111111111111111111111111111111111111111111111111111111111111111111111111111111111111111111111111111111111111111111111111111111111110
11111111111111111111111111111111111111111111111111111111111111111111111111111111111111111111111111111111111111111111111111111111111111111110
11111111111111111111111111111111111111111111111111111111111111111111111111111111111111111111111111111111111111111111111111111111111111111110
11111111111111111111111111111111111111111111111111111111111111111111111111111111111111111111111111111111111111111111111111111111111111111110
11111111111111111111111111111111111111111111111111111111111111000000111000001111111111111111111111111111111111111111111111111111111111111110
11111111111111111111111111111111111111111111111111111111111111000000101000000111111111111111111111111111111111111111111111111111111111111110
11111111111111111111111111111111111111111111111111111111111111001110000001110011111111111111111111111111111111111111111111111111111111111110
11111111111111111111111111111111111111111111111111111111111111001110000001110011111111111111111111111111111111111111111111111111111111111110
11111111111111110000001111111111111111111111111111111111111111001111111111110011111111111111111111111111111111111111111111111111111111111110
11111111111111110000001111111111111111111111111111111111111111001111111111110011111111111111111111111111111111111111111111111111111111111110
11111111111111110000001111111111111111111111111111111111111111001111111111110011111111111111111111111111111111111111111111111111111111111110
11111111111111110000001111111111111111111111111111111111111111000000000000000011111111111111111111111111111111111111111111111111111111111110
11111111111111110000001111111111111111111111111111111111111111000000000000000011111111111111111111111111111111111111111111111111111111111110
11111111111111110000000111111111111111111111111111111111111111000000000000000011111111111111111111111111111111111111111111111111111111111110
11111111111111110000000000000000000000111111111111111111111100000000000000000000001111111111110000000000000000000011111111111111111111111110
11111111111111110000000000000000000000111111111111111111111100000110111101100000001111111111110000000000000000000001111111111111111111111110
11111111111111110000000000000000000000111111111111111111111100000100111100100000001111111111110000000000000000000000111111111111111111111110
11111111111111110000000000000000000000111111111111111111111100000100111100100000001111111111110000000000000000000000111111111111111111111110
11111111111111110000000000000000000000111111111111111111111100000110111101100000001111111111110000000000000000000000111111111111111111111110
11111111111111110000000000000000000000111111111111111111111100000000000000000000001111111111110000000000000000000000111111111111111111111110
11111111111111110000001111111111111111111111111111111111111111000000000000000011111111111111111111110000000000000000111111111111111111111110
11111111111111110000001111111111111111111111111111111111111111000000000000000011111111111111111111110000000000000000111111111111111111111110
11111111111111110000001111111111111111111111111111111111111111111111111111111111111111111111111111111101111011000000111111111111111111111110
11111111111111110000001111111111111111111111111111111111111111111111111111111111111111111111111111111001111001000000111111111111111111111110
11111111111111110000001111111111111111111111111111111111111111111111111111111111111111111111111111111001111001000000111111111111111111111110
11111111111111110000001111111111111111111111111111111111111111111111111111111111111111111111111111111101111011000000111111111111111111111110
11111111111111110000001111111111111111111111111111111111111111111111111111111111111111111111111111111111111111000000111111111111111111111110
11111111111111110000001111111111111111111111111111111111111111111111111111111111111111111111111111111111111111000000111111111111111111111110
11111111111111110000001111111111111111111111111111111111111111111111111111111111111111111111111111111111111111000000111111111111111111111110
11111111111111110000001111111111111111111111111111111111111111111111111111111111111111111111111111111111111111000000111111111111111111111110
11111111111111110000001111111111111111111111111111111111111111111111111111111111111111111111111111111111111111000000111111111111111111111110
11111111111111110000001111111111111111111111111111111111111111111111111111111111111111111111111111111111111111000000111111111111111111111110
11111111111111110000001111111111111111111111111111111111111111111111111111111111111111111111111111111111111111000000111111111111111111111110
11111111111111110000001111111111111111111111111111111111111111111111111111111111111111111111111111111111111111000000111111111111111111111110
11111111111111110000001111111111111111111111111111111111111111111111111111111111111111111111111111111111111111000000111111111111111111111110
11111111111111110000001111111111111111111111111111111111111111111111111111111111111111111111111111111111111111000000111111111111111111111110
11111111111111110000001111111111111111111111111111111111111111111111111111111111111111111111111111111111111111000000111111111111111111111110
11111111111111110000001111111111111111111111111111111111111111111111111111111111111111111111111111111111111111000000111111111111111111111110
11111111111111111111111111111111111111111111111111111111111111111111111111111111111111111111111111111111111111111111111111111111111111111110
11111111111111111111111111111111111111111111111111111111111111111111111111111111111111111111111111111111111111111111111111111111111111111110
11111111111111111111111111111111111111111111111111111111111111111111111111111111111111111111111111111111111111111111111111111111111111111110
11111111111111111111111111111111111111111111111111111111111111111111111111111111111111111111111111111111111111111111111111111111111111111110
11111111111111111111111111111111111111111111111111111111111111111111111111111111111111111111111111111111111111111111111111111111111111111110
11111111111111111111111111111111111111111111111111111111111111111111111111111111111111111111111111111111111111111111111111111111111111111110
11111111111111111111111111111111111111111111111111111111111111111111111111111111111111111111111111111111111111111111111111111111111111111110
11111111111111111111111111111111111111111111111111111111111111111111111111111111111111111111111111111111111111111111111111111111111111111110
11111111111111111111111111111111111111111111111111111111111111111111111111111111111111111111111111111111111111111111111111111111111111111110
11111111111111111111111111111111111111111111111111111111111111111111111111111111111111111111111111111111111111111111111111111111111111111110
11111111111111111111111111111111111111111111111111111111111111111111111111111111111111111111111111111111111111111111111111111111111111111110
11111111111111111111111111111111111111111111111111111111111111111111111111111111111111111111111111111111111111111111111111111111111111111110
11111111111111110000001111111111111111111111111111111111111111111111111111111111111111111111111111111111111111000000111111111111111111111110
11111111111111110000001111111111111111111111111111111111111111111111111111111111111111111111111111111111111111000000111111111111111111111110
11111111111111110000001111111111111111111111111111111111111111111111111111111111111111111111111111111111111111000000111111111111111111111110
11111111111111110000001111111111111111111111111111111111111111111111111111111111111111111111111111111111111111000000111111111111111111111110
11111111111100000000000000000000000000001111111111111111111111010000000000001011111111111111111111110000000000000000000000000001111111111110
11111111111100000000000100100100000000001111111111111111111110010000000000001001111111111111111111110000000000000000000000000001111111111110
11111111111100000000100000000000100000001111111111111111111100000111100111100000111111111111111111110000100100001010000000000000111111111110
11111111111100000000000000000000000000001111111111111111111100000111100111100000111111111111111111110000000000000000000000000000111111111110
11111111111100000000000111111000000000001111111111111111111100000000111100000000111111111111111111110000111110011111000111110000111111111110
11111111111100000001111111111111100000001111111111111111111100000000111100000000111111111111111111110010111110011111010111110000111111111110
11111111111100001001111111111111100100000011111111110000001100010000000000001000110000001111111111000000111110011111000111110000111111111110
11111111111100000001111111111111100000000011111111110000001100010000000000001000110000001111111111000000111110011111000111110000111111111110
11111111111100000001111111111111100000000011111111110000000000011100000000111000000000001111111111000010111110011111010111110000111111111110
11111111111100001001111111111111100100000011111111110000000000000000000000000000000000001111111111000000111110011111000111110000111111111110
11111111111100000001111111111111100000000011111111110000000000000000000000000000000000001111111111000000000000000000000111110000111111111110
11111111111100000000000111111000000000000011111111110000000000000011000110000000000000001111111111000000100100000000001111110000111111111110
11111111111100000000000000000000000000001111111111111100000000000011111110000000000000111111111111110000000000001111111111110000111111111110
11111111111100000000100000000000100000001111111111111100000000000011111110000000000000111111111111110000000000001111111111110000111111111110
11111111111100000000000100100100000000001111111111111111110000000000000000000000001111111111111111110000000000001100001100000000111111111110
11111111111100000000000000000000000000001111111111111111110000000000000000000000001111111111111111110000000000000000000000000000111111111110
11111111111100000000000000000000000000001111111111111111111100000000000000000000111111111111111111110000000000000000000000000000111111111110
11111111111100000000000000000000000000001111111111111111111100000000000000000000111111111111111111110000000000000000000000000000111111111110
11111111111111111111111111111111111111111111111111111111111111111100000000111111111111111111111111111111111111111111111111111111111111111110
11111111111111111111111111111111111111111111111111111111111111111100000000111111111111111111111111111111111111111111111111111111111111111110
11111111111111111111111111111111111111111111111111111111111111111100000000111111111111111111111111111111111111111111111111111111111111111110
11111111111111111111111111111111111111111111111111111111111111111100000000111111111111111111111111111111111111111111111111111111111111111110
11111111111111111111111111111111111111111111111111111111111111111111111111111111111111111111111111111111111111111111111111111111111111111110
11111111111111111111111111111111111111111111111111111111111111111111111111111111111111111111111111111111111111111111111111111111111111111110
11111111111111111111111111111111111111111111111111111111111111111111111111111111111111111111111111111111111111111111111111111111111111111110
11111111111111111111111111111111111111111111111111111111111111111111111111111111111111111111111111111111111111111111111111111111111111111110
11111111111111111111111111111111111111111111111111111111111111111111111111111111111111111111111111111111111111111111111111111111111111111110
11111111111111111111111111111111111111111111111111111111111111111111111111111111111111111111111111111111111111111111111111111111111111111110
11111111111111111111111111111111111111111111111111111111111111111111111111111111111111111111111111111111111111111111111111111111111111111110
11111111111111111111111111111111111111111111111111111111111111111111111111111111111111111111111111111111111111111111111111111111111111111110
11111111111111111111111111111111111111111111111111111111111111111111111111111111111111111111111111111111111111111111111111111111111111111110
11111111111111111111111111111111111111111111111111111111111111111111111111111111111111111111111111111111111111111111111111111111111111111110
