00000000000000000000000000000000000000000000000000000000000000000000000000000000000000000000000000000000000000000000000000000000000000000000000000000000000000000000000000000000000000000000000000000000
11111111111111111111111111111111111111111111111111111111111111111111111111111111111111111111111111111111111111111111111111111111111111111111111111111111111111111111111111111111111111111111111111111110
11111111111111111111111111111111111111111111111111111111111111111111111111111111111111111111111111111111111111111111111111111111111111111111111111111111111111111111111111111111111111111111111111111110
11111111111111111111111111111111111111111111111111111111111111111111111111111111111111111111111111111111111111111111111111111111111111111111111111111111111111111111111111111111111111111111111111111110
11111111111111111111111111111111111111111111111111111111111111111111111111111111111111111111111111111111111111111111111111111111111111111111111111111111111111111111111111111111111111111111111111111110
11111111111111111111111111111111111111111111111111111111111111111111111111111111111111111111111111111111111111111111111111111111111111111111111111111111111111111111111111111111111111111111111111111110
11111111111111111111111111111111111111111111111111111111111111111111111111111111111111111111111111111111111111111111111111111111111111111111111111111111111111111111111111111111111111111111111111111110
11111111111111111111111111111111111111111111111111111111111111111111111111111111111111111111111111111111111111111111111111111111111111111111111111111111111111111111111111111111111111111111111111111110
11111111111111111111111111111100000011111111111111111111111111111111111111111111111111111111111111111111111111111111111111111111111111111111111111111111111111111100001010000001010000000010100011111110
11111111111111111111111111111100000011111111111111111111111111111111111111111111111111111111111111111111111111111111111111111111111111111111111111111111111111111110000000000000000000000000000011111110
11111111111111111111111111111100000011111111111111111111111111111111111111111111111111111111111111111111111111111111111111111111111111111111111111111111111111111110001111100011111000000111110011111110
11111111111111111111111111111100000011111111111111111111111111111111111111111111111111111111111111111111111111111111111111111111111111111111111111111111111111111110001111100011111000010111110111111110
11111111111111000000110111111100000000001111111111111111111111111111111111111111111111111111111111111111111111111111111111111111111111111111111111111111111111111110001111100011111000000111110011111110
11111111111111000000110100100100000000001111111111111111111111111111111111111111111111111111111111111111111111111111111111111111111111111111111111111111111111111110000000000000000000001111111011111110
11111111101111000001110000000000000000001111111111111111111111111111111111111111111111111111111111111111111111111111111111111111111111111111111111111111111111111110000100000000000000000111110011111110
11111111001000000000010000000000000000111111111111111111111111111111111111111111111111111111111111111111111111111111111111111111111111111111111111111111111111111111111111111111111111100000100011111110
11111111001100000000010000000000000000111111111111111111111111111111111111111111111111111111111111111111111111111111111111111111111111111111111111111111111111111100000000000000000000100010000011111110
11111111000000000000010000000000000000011111111111111111111111111111111111111111111111111111111111111111111111111111111111111111111111111111111111111111111111111100000101000010101000100000000011111110
11111111000000000001110000011111100000011111111111111111111111111111111111111111111111111111111111111111111111111111111111111111111111111111111111111111111111111100000000000000000000100000000011111110
11111111000100000001110000011111100000111111111111111111111111111111111111111111111111111111111111111111111111111111111111111111111111111111111111111111111111111100001111100011111000100000000011111110
11111111000000000000000000011111100000011111111111111111111111111111111111111111111111111111111111111111111111111111111111111111111111111111111111111111111111111100001111100011111000100011100011111110
11111111101111000000000000011111100000011111111111111111111111111111111111111111111111111111111111111111111111111111111111111111111111111111111111111111111111111100001111100011111000100011101011111110
11111111111111000011110000000000000000111111111111111111111111111111111111111111111111111111111111111111111111111111111111111111111111111111111111111111111111111100001111100011111000100011100011111110
11111111111111000111110000000000000000011111111111111111111111111111111111111111111111111111111111111111111111111111111111111111111111111111111111111111111111111100001111100011111000100011101011111110
11111111111111111111110000000000000000011111111111111111111111111111111111111111111111111111111111111111111111111111111111111111111111111111111111111111111111111100000000000000000000100011100011111110
11111111111111111111110000000000000000111111111111111111111111111111111111111111111111111111111111111111111111111111111111111111111111111111111111111111111111111100000101000000010000100000000011111110
11111111111111111111111111111111111000010111000000111111111111111111111111111111111111111111111111111111111111111111111111111111111111111111111111111111111111110000000000000000000000100000000011111110
11111111111111111111111100011100011000010111000000111111111111111111111111111111111111111111111111111111111111111111111111111111111111111111111111111111111111110000000000000011111100100011100011111110
11111111111111111100001101011101011000000111010000000011111111111111111111111111111111111111111111111111111111111111111111111111111111111111111111111111111111110000000010100011111100101011110011111110
11111111111111111100000000000000000000000111000000000011111111111111111111111111111111111111111111111111111111111111111111111111111111111111111111111111111111110000000000000011111101100011100011111110
11111111111111111100000000000000000000010100000000000011111111111111111111111111111111111111111111100000111111111111111110111111111111111111111111111111111111110000001111100011111100101011101011111110
11111111111111111100100000100001000010010000000000000011111111111111111111111111111111111111111101111111111111111111111110111111111111111111111111111111111111110000001111100011111101100011100011111110
11111111111111111100000000000000000000010000000011000000111111111111111111111111111111111111111101111111000000000011111110111111111111111111111111111111111111110000001111100011111100100000000011111110
11111111111111111111111011110111110111110100000011000000111111111111111111111111111111111111111101111111000000000011111110111111111111111111111111111111111111110000001111100011111101100000000011111110
11111111111111111111111011110111110111110011110000000000001111111111111111111111111111111111111100000000000000000000000000111111111111111111111111111111111111111100001111100011111100100011100011111110
11111111111111111111111011110111110111110011110000000000001111111111111111111111111111111111111100000000000000000000000000111111111111111111111111111111111111111100001111100011111101101011110011111110
11111111111111111111111111111111111111111111111111111111111111111111111111111111111111111111111100000000000000000000000000111111111111111111111111111111111111111100000000000011111100100011100011111110
11111111111111111111111111111111111111111111111111111111111111111111111111111111111111111111111100000000000000000000000000111111111111111111111111111111111111111100000101000000000000100011110011111110
11111111111111111111111111111111111111111111111111111111111111111111111111111111111111111111111100001111111100001111110000111111111111111111111111111111111111111100000000000000000000100011100011111110
11111111111111111111111111111111111111111111111111111111111111111111111111111111111111111111111100001111111100001111111000111111111111111111111111111111111111111100000000000000000000100000000011111110
11111111111111111111111111111111111111111111111111111111111111111111111111111111111111111111111100000000000000000000001111111111111111111111111111111111111111111100000000001111111111100000000011111110
11111111111111111111111111111111111111111111111111111111111111111111111111111111111111111111111100000000000000000000001111111111111111111111111111111111111111111100000000000000000000000000000011111110
11111111111111111111111111111111111111111111111111111111111111111111111111111111111111111111111100000000000000000000001111111111111111111111111111111111111111111100000000000000000000000000000011111110
11111111111111111111111111111111111111111111111111111111111111111111111111111111111111111111111100000000000000000000001111111111111111111111111111111111111111111100000000001111111111100000000011111110
11111111111111111111111111111111111111111111111111111111111111111111111111111111111111111111111100000000000000000000001111111111111111111111111111111111111111111100000000000000000011100000000011111110
11111111111111111111111111111111111111111111111111111111111111111111111111111111111111111111111100000000000000000000001111111111111111111111111111111111111111111100000000000000000011111111111111111110
11111111111111111111111111111111111111111111111111111111111111111111111111111111111111111111111111110000001111110000001111111111111111111111111111111111111111111111111111111111111111111111111111111110
11111111111111111111111111111111111111111111111111111111111111111111111111111111111111111111111111110000001111110000001111111111111111111111111111111111111111111111111111111111111111111111111111111110
11111111111111111111111111111111111111111111111111111111111111111111111111111111111111111111111111111111111111111111111111111111111111111111111111111111111111111111111111111111111111111111111111111110
11111111111111111111111111111111111111111111111111111111111111111111111111111111111111111111111111111111111111111111111111111111111111111111111111111111111111111111111111111111111111111111111111111110
11111111111111111111111111111111111111111111111111111111111111111111111111111111111111111111111111111111111111111111111111111111111111111111111111111111111111111111111111111111111111111111111111111110
11111111111111111111111111111111111111111111111111111111111111111111111111111111111111111111111111111111111111111111111111111111111111111111111111111111111111111111111111111111111111111111111111111110
11111111111111111111111111111111111111111111111111111111111111111111111111111111111111111111111111111111111111111111111111111111111111111111111111111111111111111111111111111111111111111111111111111110
11111111111111111111111111111111111111111111111111111111111111111111111111111111111111111111111111111111111111111111111111111111111111111111111111111111111111111111111111111111111111111111111111111110
11111111111111111111111111111111111111111111111111111111111111111111111111111111111111111111111111111111111111111111111111111111111111111111111111111111111111111111111111111111111111111111111111111110
11111111111111111111111111111111111111111111111111111111111111111111111111111111111111111111111111111111111111111111111111111111111111111111111111111111111111111111111111111111111111111111111111111110
11111111111111111111111111111111111111111111111111111111111111111111111111111111111111111111111111111111111111111111111111111111111111111111111111111111111111111111111111111111111111111111111111111110
11111111111111111111111111111111111111111111111111111111111111111111111111111111111111111111111111111111111111111111111111111111111111111111111111111111111111111111111111111111111111111111111111111110
11111111111111111111111111111111111111111111111111111111111111111111111111111111111111111111111111111111111111111111111111111111111111111111111111111111111111111111111111111111111111111111111111111110
11111111111111111111111111111111111111111111111111111111111111111111111111111111111111111111111111111111111111111111111111111111111111111111111111111111111111111111111111111111111111111111111111111110
11111111111111111111111111111111111111111111111111111111111111111111111111111111111111111111111111111111111111111111111111111111111111111111111111111111111111111111111111111111111111111111111111111110
11111111111111111111111111111111111111111111111111111111111111111111111111111111111111111111111111111111111111111111111111111111111111111111111111111111111111111111111111111111111111111111111111111110
11111111111111111111111111111111111111111111111111111111111111111111111111111111111111111111111111111111111111111111111111111111111111111111111111111111111111111111111111111111111111111111111111111110
11111111111111111111111111111111111111111111111111111111111111111111111111111111111111111111111111111111111111111111111111111111111111111111111111111111111111111111111111111111111111111111111111111110
11111111111111111111111111111111111111111111111111111111111111111111111111111111111111111111111111111111111111111111111111111111111111111111111111111111111111111111111111111111111111111111111111111110
11111111111111111111111111111111111111111111111111111111111111111111111111111111111111111111111111111111111111111111111111111111111111111111111111111111111111111111111111111111111111111111111111111110
11111111111111111111111111111111111111111111111111111111111111111111111111111111111111111111111111111111111111111111111111111111111111111111111111111111111111111111111111111111111111111111111111111110
11111111111111111111111111111111111111111111111111111111111111111111111111111111111111111111111111111111111111111111111111111111111111111111111111111111111111111111111111111111111111111111111111111110
11111111111111111111111111111111111111111111111111111111111111111111111111111111111111111111111111111111111111111111111111111111111111111111111111111111111111111111111111111111111111111111111111111110
11111111111111111111111111111111111111111111111111111111111111111111111111111111111111111111111111111111111111111111111111111111111111111111111111111111111111111111111111111111111111111111111111111110
11111111111111111111111111111100000011111111111111111111111111111111111111111111111111111111111111111111111111111111111111111111111111111111111111111111111111111111111111111111111111111111111111111110
11111111111111111111111111111100000011111111111111111111111111111111111111111111111111111111111111111111111111111111111111111111111111111111111111111111111111111111111111111111111111111111111111111110
11111111111111111111111111111100110011111111110000111111111111111111111111111111111111111111111111111111111111111111111111111111111111111111111111111111111111111111111111111111111111111111111111111110
11111111111111111111111111111100110011111111110000111111111111111111111111111111111111111111111111111111111111111111111111111111111111111111111111111111111111111111111111111111111111111111111111111110
11111111111111111111111111111100111111001100000000111111111111111111111111111111111111111111111111110000001111110000001111111111111111111111111111111111111111111111111111111111111111111111111111111110
11111111111111111111111111111100000000001100000000111111111111111111111111111111111111111111111111110000001111110000001111111111111111111111111111111111111111111111111111111111111111111111111111111110
11111111111111111111111111111100000000000000000000111111111111111111111111111111111111111111111111000000000000000000000011111111111111111111111111111111111111111111111111111111111111111111111111111110
11111111111111111111111111111100000000000000000000111111111111111111111111111111111111111111111111000000000000000000000011111111111111111111111111111111111111111111111111111111111111111111111111111110
11111111111111111111111111110000000000110011100000000011111111111111111111111111111111111111110000000000000000000000000000001111111111111111111111111111111111111111111111111111111111111111111111111110
11111111111111111111111111110000000000111111110000000011111111111111111111111111111111111111110000000111000000000001110000001111111111111111111111111111111111111111111111111111111111111111111111111110
11111111111111111111111111110000000000001111111000000011111111111111111111111111111111111111110000000111000000000001110000001111111111111111111111111111111111111111111111111111111111111111111111111110
11111111111111111111111111110000000000001111111000000011111111111111111111111111111111111111110000011111000000000111110000001111111111111111111111111111111111111111111111111111111111111111111111111110
11111111111111111111111111110000000000001111111000000011111111111111111111111111111111111111110000011111000000000111110000001111111111111111111111111111111111111111111111111111111111111111111111111110
11111111111111111111111111110000000000001111111000000011111111111111111111111111111111111111110000000111000000000001110000001111111111111111111111111111111111111111111111111111111111111111111111111110
11111111111111111111111111110000000000111111110000000011111111111111111111111111111111111111110000000111000000000001100000001111111111111111111111111111111111111111111111111111111111111111111111111110
11111111111111111111111111110000000000110011100000000011111111111111111111111111111111111111110000000000000000000000000000001111111111111111111111111111111111111111111111111111111111111111111111111110
11111111111111111111111111111100000000000000000000111111111111111111111111111111111111111111111111000000000000000000000011111111111111111111111111111111111111111111111111111111111111111111111111111110
11111111111111111111111111111100000000000000000000111111111111111111111111111111111111111111111111000000000000000000000011111111111111111111111111111111111111111111111111111111111111111111111111111110
11111111111111111111111111111111110000000000000000111111111111111111111111111111111111111111111111110000001111110000001111111111111111111111111111111111111111111111111111111111111111111111111111111110
11111111111111111111111111111111110000001100000000111111111111111111111111111111111111111111111111110000001111110000001111111111111111111111111111111111111111111111111111111111111111111111111111111110
11111111111111111111111111111111110000001100000000111111111111111111111111111111111111111111111111111111111111111111111111111111111111111111111111111111111111111111111111111111111111111111111111111110
11111111111111111111111111111111110000000000000000111111111111111111111111111111111111111111111111111111111111111111111111111111111111111111111111111111111111111111111111111111111111111111111111111110
11111111111111111111111111111111110000111111110011111111111111111111111111111111111111111111111111111111111111111111111111111111111111111111111111111111111111111111111111111111111111111111111111111110
11111111111111111111111111111111110000111111110011111111111111111111111111111111111111111111111111111111111111111111111111111111111111111111111111111111111111111111111111111111111111111111111111111110
11111111111111111111111111111111111111111111111111111111111111111111111111111111111111111111111111111111111111111111111111111111111111111111111111111111111111111111111111111111111111111111111111111110
11111111111111111111111111111111111111111111111111111111111111111111111111111111111111111111111111111111111111111111111111111111111111111111111111111111111111111111111111111111111111111111111111111110
11111111111111111111111111111111111111111111111111111111111111111111111111111111111111111111111111111111111111111111111111111111111111111111111111111111111111111111111111111111111111111111111111111110
11111111111111111111111111111111111111111111111111111111111111111111111111111111111111111111111111111111111111111111111111111111111111111111111111111111111111111111111111111111111111111111111111111110
11111111111111111111111111111111111111111111111111111111111111111111111111111111111111111111111111111111111111111111111111111111111111111111111111111111111111111111111111111111111111111111111111111110
11111111111111111111111111111111111111111111111111111111111111111111111111111111111111111111111111111111111111111111111111111111111111111111111111111111111111111111111111111111111111111111111111111110
11111111111111111111111111111111111111111111111111111111111111111111111111111111111111111111111111111111111111111111111111111111111111111111111111111111111111111111111111111111111111111111111111111110
11111111111111111111111111111111111111111111111111111111111111111111111111111111111111111111111111111111111111111111111111111111111111111111111111111111111111111111111111111111111111111111111111111110
11111111111111111111111111111111111111111111111111111111111111111111111111111111111111111111111111111111111111111111111111111111111111111111111111111111111111111111111111111111111111111111111111111110
11111111111111111111111111111111111111111111111111111111111111111111111111111111111111111111111111111111111111111111111111111111111111111111111111111111111111111111111111111111111111111111111111111110
11111111111111111111111111111111111111111111111111111111111111111111111111111111111111111111111111111111111111111111111111111111111111111111111111111111111111111111111111111111111111111111111111111110
11111111111111111111111111111111111111111111111111111111111111111111111111111111111111111111111111111111111111111111111111111111111111111111111111111111111111111111111111111111111111111111111111111110
11111111111111111111111111111111111111111111111111111111111111111111111111111111111111111111111111111111111111111111111111111111111111111111111111111111111011111111111111111111111111111111111111111110
11111111111111111111111111111111111111111111111111111111111111111111111111111111111111111111111111111111111111111111111111111111111111111111111111111111111011111111111111111111111111111111111111111110
11111111111111111111111111111111111111111111111111111111111111111111111111111111111111111111111111111111111111111111111111111111111111111111111111111111111001111111101101111111111101111100000000111110
11111111111111111111111111111111111111111111111111111111111111111111111111111111111111111111111111111111111111111111111111111111111111111111111111111111111000000000001101111111111101111100000000111110
11111111111111111111111111111111111111111111111111111111111111111111111111111111111111111111111111111111111111111111111111111111111111111111111111111111110000000000000000000000011100000000000000111110
11111111111111111111111111111111111111111111111111111111111111111111111111111111111111111111111111111111111111111111111111111111111111111111111111111111110000000000000000000000011100000000000000111110
11111111111111111111111111111111111111111111111111111111111111111111111111111111111111111111111111111111111111111111111111111111111111111111111111111111111100000000000000000000000000000000000000111110
11111111111111111111111111111111111111111111111111111111111111111111111111111111111111111111111111111111111111111111111111111111111111111111111111111111111000000000000000000000000000000000000000111110
11111111111111111111111111111111111111111111111111111111111111111111111111111111111111111111111111111111111111111111111111111111111111111111111111111111111000000000000000000000000000000000001111111110
11111111111111111111111111111111111111111111111111111111111111111111111111111111111111111111111111111111111111111111111111111111111111111111111111111111111100000000000000000000000000000000001111111110
11111111111111111111111111111111111111111111111111111111111111111111111111111111111111111111111111110000001111110000001111111111111111111111111111111111111000000000000000000000000011110000111111111110
11111111111111111111111111111111111111111111111111111111111111111111111111111111111111111111111111110000001111110000001111111111111111111111111111111111111000000000000000000000000011110000111111111110
11111111111111111111111111111111111111111111111111111111111111111111111111111111111111111111111111110000000000000000001111111111111111111111111111111111111100100100000000000000101111100000111111111110
11111111111111111111111111111111111111111111111111111111111111111111111111111111111111111111111111110000001000010000001111111111111111111111111111111111111111111100000000000000001111100000111111111110
11111111111111111111111111111111111111111111111111111111111111111111111111111111111111111111111111000000001111110000011111111111111111111111111111111111111111111100001111110001101111100000001111111110
11111111111111111111111111111111111111111111111111111111111111111111111111111111111111111111111111000000000000000000011111111111111111111111111111111111111111111100001111110001101111100000101111111110
11111111111111111111111111111111111111111111111111111111111111111111111111111111111111111111111100000000000000000000001111111111111111111111111111111111111111110000000011110000001111100000001111111110
11111111111111111111111111111111111111111111111111111111111111111111111111111111111111111111111100000000000000000000001111111111111111111111111111111111110000000000000011110000101111100000001111111110
11111111111111111111111111111111111111111111111111111111111111111111111111111111111111111111111100111111000011111100001111111111111111111111111111111111110000000000000011110000111111111111111111111110
11111111111111111111111111111111111111111111111111111111111111111111111111111111111111111111111100111111000011111100001111111111111111111111111111111111110000000000000011110000111111111111111111111110
11111111111111111111111111111111111111111111111111111111111111111111111111111111111111111111111100000000000000000000001111111111111111111111111111111111110000000000000000110000011111111111111111111110
11111111111111111111111111111111111111111111111111111111111111111111111111111111111111111111111100000000000000000000011111111111111111111111111111111111110000000000000000110000010111111111111111111110
11111111111111111111111111111111111111111111111111111111111111111111111111111111111111111111111100000000000000000000011111111111111111111111111111111111110000000000000000110000000111111111111111111110
11111111111111111111111111111111111111111111111111111111111111111111111111111111111111111111111100000000000000000000011111111111111111111111111111111111111100000000000001110000000111111111111111111110
11111111111111111111111111111111111111111111111111111111111111111111111111111111111111111111111100000000000000000000011111111111111111111111111111111111111000000000100001110000000011111111111111111110
11111111111111111111111111111111111111111111111111111111111111111111111111111111111111111111111100000000000000000000001111111111111111111111111111111111111000000000100001110000000111111111111111111110
11111111111111111111111111111111111111111111111111111111111111111111111111111111111111111111111100111111111111110000001111111111111111111111111111111111111110010000100001110000000111111111111111111110
11111111111111111111111111111111111111111111111111111111111111111111111111111111111111111111111100111111111111110000001111111111111111111111111111111111111111110000100001110000000111111111111111111110
11111111111111111111111111111111111111111111111111111111111111111111111111111111111111111111111100000000000000000000001111111111111111111111111111111111111111111111111111111111111111111111111111111110
11111111111111111111111111111111111111111111111111111111111111111111111111111111111111111111111100000000000000000000001111111111111111111111111111111111111111111111111111111111111111111111111111111110
11111111111111111111111111111111111111111111111111111111111111111111111111111111111111111111111100000000000000000000011111111111111111111111111111111111111111111111111111111111111111111111111111111110
11111111111111111111111111111111111111111111111111111111111111111111111111111111111111111111111100000000000000000000011111111111111111111111111111111111111111111111111111111111111111111111111111111110
11111111111111111111111111111111111111111111111111111111111111111111111111111111111111111111111111111111111111111111111111111111111111111111111111111111111111111111111111111111111111111111111111111110
11111111111111111111111111111111111111111111111111111111111111111111111111111111111111111111111111111111111111111111111111111111111111111111111111111111111111111111111111111111111111111111111111111110
